"SV.key","Type","Chromosome","Pos","Length","Species","SV.freq","End"
"chr11:64818814:<DEL>:4308:11044.81","<DEL>","chr11",64818814,4308,"Macaque",1,64823122
"chr16:2812806:<DEL>:1046:37371.17","<DEL>","chr16",2812806,1046,"Macaque",1,2813852
"chr7:99796295:<DEL>:1491:25303.34","<DEL>","chr7",99796295,1491,"Macaque",1,99797786
"chr9:356739:<DEL>:541:16880.1","<DEL>","chr9",356739,541,"Macaque",1,357280
"chr5:65486410:<DUP>:77874:11677.18","<DUP>","chr5",65486410,77874,"Macaque",1,65564284
"chr10:83787095:<DEL>:870:11485.17","<DEL>","chr10",83787095,870,"Macaque",1,83787965
"chr15:36825315:<DEL>:4659:27953.97","<DEL>","chr15",36825315,4659,"Macaque",1,36829974
"chr11:3233703:<DEL>:1143:26356.34","<DEL>","chr11",3233703,1143,"Macaque",1,3234846
"chr3:184916028:<DEL>:764:30417.16","<DEL>","chr3",184916028,764,"Macaque",1,184916792
"chr12:100176411:<DEL>:2436:12423.91","<DEL>","chr12",100176411,2436,"Macaque",1,100178847
"chr1:1265394:<DEL>:506:50388.08","<DEL>","chr1",1265394,506,"Macaque",1,1265900
"chr19:24782056:<DEL>:737:57932.68","<DEL>","chr19",24782056,737,"Macaque",1,24782793
"chr7:153961488:<DEL>:7835:57696.36","<DEL>","chr7",153961488,7835,"Macaque",1,153969323
"chr19:27119393:<DEL>:3655:32161.26","<DEL>","chr19",27119393,3655,"Macaque",1,27123048
"chr15:64669011:<DEL>:703:12864.84","<DEL>","chr15",64669011,703,"Macaque",1,64669714
"chr10:58305498:<DEL>:450:36107.04","<DEL>","chr10",58305498,450,"Macaque",1,58305948
"chr6:40722569:<DEL>:576:16339.69","<DEL>","chr6",40722569,576,"Macaque",1,40723145
"chr2:100302613:<DEL>:1113:30721.16","<DEL>","chr2",100302613,1113,"Macaque",1,100303726
"chr13:105797375:<DEL>:2052:46145.27","<DEL>","chr13",105797375,2052,"Macaque",1,105799427
"chr15:1128513:<DEL>:391:23865.67","<DEL>","chr15",1128513,391,"Macaque",1,1128904
"chr14:10845139:<DEL>:779:35354.31","<DEL>","chr14",10845139,779,"Macaque",1,10845918
"chr4:3681388:<DEL>:46054:20473.94","<DEL>","chr4",3681388,46054,"Macaque",1,3727442
"chr15:102738435:<DEL>:898:57046.45","<DEL>","chr15",102738435,898,"Macaque",1,102739333
"chr19:472788:<DEL>:3685:39011.71","<DEL>","chr19",472788,3685,"Macaque",1,476473
"chr14:72023447:<DEL>:566:28769.42","<DEL>","chr14",72023447,566,"Macaque",1,72024013
"chr20:1404847:<DEL>:626:29074.34","<DEL>","chr20",1404847,626,"Macaque",1,1405473
"chr14:10499175:<DEL>:2132:37900.91","<DEL>","chr14",10499175,2132,"Macaque",1,10501307
"chr18:68998440:<DEL>:591:11972.41","<DEL>","chr18",68998440,591,"Macaque",1,68999031
"chr19:46625673:<DEL>:2150:32053.51","<DEL>","chr19",46625673,2150,"Macaque",1,46627823
"chr7:167304999:<DEL>:1487:18717.49","<DEL>","chr7",167304999,1487,"Macaque",1,167306486
"chr8:100110406:<DEL>:687:20881.73","<DEL>","chr8",100110406,687,"Macaque",1,100111093
"chr4:43177177:<DEL>:802:19574.53","<DEL>","chr4",43177177,802,"Macaque",1,43177979
"chr12:72970216:<DEL>:2711:26322.31","<DEL>","chr12",72970216,2711,"Macaque",1,72972927
"chr3:63185144:<DUP>:615:18485.45","<DUP>","chr3",63185144,615,"Macaque",1,63185759
"chr6:7572876:<DEL>:32854:38581.95","<DEL>","chr6",7572876,32854,"Macaque",1,7605730
"chr10:56453116:<DUP>:847:21593.87","<DUP>","chr10",56453116,847,"Macaque",1,56453963
"chr9:23913464:<DEL>:621:29561.18","<DEL>","chr9",23913464,621,"Macaque",1,23914085
"chr5:152809392:<DEL>:461:22612.5","<DEL>","chr5",152809392,461,"Macaque",1,152809853
"chr16:1039604:<DEL>:1889:4631.67","<DEL>","chr16",1039604,1889,"Macaque",1,1041493
"chr1:9329503:<DEL>:2101:16611.06","<DEL>","chr1",9329503,2101,"Macaque",1,9331604
"chr8:140734875:<DEL>:589:51884.04","<DEL>","chr8",140734875,589,"Macaque",1,140735464
"chr2:10824029:<DEL>:1138:48331.42","<DEL>","chr2",10824029,1138,"Macaque",1,10825167
"chr5:789796:<DEL>:312:60652.58","<DEL>","chr5",789796,312,"Macaque",1,790108
"chr7:706269:<DEL>:402:70206.37","<DEL>","chr7",706269,402,"Macaque",1,706671
"chr20:4240862:<DEL>:4389:37755.18","<DEL>","chr20",4240862,4389,"Macaque",1,4245251
"chr2:174077932:<DEL>:1488:28141.43","<DEL>","chr2",174077932,1488,"Macaque",1,174079420
"chr17:42716294:<DUP>:957:8752.14","<DUP>","chr17",42716294,957,"Macaque",1,42717251
"chr11:69552007:<DEL>:1778:9783.12","<DEL>","chr11",69552007,1778,"Macaque",1,69553785
"chr10:88335017:<DEL>:4926:26233.26","<DEL>","chr10",88335017,4926,"Macaque",1,88339943
"chr10:1789541:<DEL>:434:11737.29","<DEL>","chr10",1789541,434,"Macaque",1,1789975
"chr13:18847550:<DUP>:491:6662.28","<DUP>","chr13",18847550,491,"Macaque",1,18848041
"chr6:139362404:<DEL>:618:12468.5","<DEL>","chr6",139362404,618,"Macaque",1,139363022
"chr1:125546098:<DEL>:664:34136.15","<DEL>","chr1",125546098,664,"Macaque",1,125546762
"chr6:173712166:<DEL>:1655:11667.19","<DEL>","chr6",173712166,1655,"Macaque",1,173713821
"chr19:34867636:<DEL>:621:13449.6","<DEL>","chr19",34867636,621,"Macaque",1,34868257
"chr8:142726379:<DEL>:506:43380.47","<DEL>","chr8",142726379,506,"Macaque",1,142726885
"chr12:42850:<DEL>:2801:19587.9","<DEL>","chr12",42850,2801,"Macaque",1,45651
"chr8:42819964:<DEL>:53512:31758.12","<DEL>","chr8",42819964,53512,"Macaque",1,42873476
"chr4:77221957:<DEL>:6510:44250.1","<DEL>","chr4",77221957,6510,"Macaque",1,77228467
"chr3:2553174:<DEL>:837:34632.84","<DEL>","chr3",2553174,837,"Macaque",1,2554011
"chr10:33960878:<DEL>:2841:30459.6","<DEL>","chr10",33960878,2841,"Macaque",1,33963719
"chr11:132037144:<DEL>:2856:33648.83","<DEL>","chr11",132037144,2856,"Macaque",1,132040000
"chr1:4064524:<DEL>:1400:45199.9","<DEL>","chr1",4064524,1400,"Macaque",1,4065924
"chr6:7359:<DUP>:688:10012.21","<DUP>","chr6",7359,688,"Macaque",1,8047
"chr8:1018411:<DEL>:608:51563.29","<DEL>","chr8",1018411,608,"Macaque",1,1019019
"chr7:98986982:<DEL>:34634:40532.21","<DEL>","chr7",98986982,34634,"Macaque",1,99021616
"chr6:152747272:<DEL>:2182:33922.86","<DEL>","chr6",152747272,2182,"Macaque",1,152749454
"chr20:31206900:<DEL>:1437:27808.32","<DEL>","chr20",31206900,1437,"Macaque",1,31208337
"chr19:33944482:<DEL>:2744:50093.94","<DEL>","chr19",33944482,2744,"Macaque",1,33947226
"chr3:45340666:<DEL>:875:41534.45","<DEL>","chr3",45340666,875,"Macaque",1,45341541
"chr11:98714835:<DEL>:938:32142.13","<DEL>","chr11",98714835,938,"Macaque",1,98715773
"chr14:113098403:<DEL>:636:60650.61","<DEL>","chr14",113098403,636,"Macaque",1,113099039
"chr17:70975262:<DEL>:2705:29690.14","<DEL>","chr17",70975262,2705,"Macaque",1,70977967
"chr5:99149831:<DEL>:427:28015.84","<DEL>","chr5",99149831,427,"Macaque",1,99150258
"chr14:17840404:<DEL>:1116:16974.37","<DEL>","chr14",17840404,1116,"Macaque",1,17841520
"chr3:38111674:<DEL>:647:13215.66","<DEL>","chr3",38111674,647,"Macaque",1,38112321
"chr4:167930053:<DEL>:310:40717.34","<DEL>","chr4",167930053,310,"Macaque",1,167930363
"chr13:21472655:<DEL>:460:13458.65","<DEL>","chr13",21472655,460,"Macaque",1,21473115
"chr20:7952120:<DEL>:1458:10282.35","<DEL>","chr20",7952120,1458,"Macaque",1,7953578
"chr19:40664722:<DEL>:1301:35222.77","<DEL>","chr19",40664722,1301,"Macaque",1,40666023
"chr1:1116785:<DEL>:865:8392.77","<DEL>","chr1",1116785,865,"Macaque",1,1117650
"chr6:67165941:<DEL>:579:30166.07","<DEL>","chr6",67165941,579,"Macaque",1,67166520
"chr7:5102763:<DEL>:46894:19854.17","<DEL>","chr7",5102763,46894,"Macaque",1,5149657
"chr5:60573501:<DEL>:290:35694.82","<DEL>","chr5",60573501,290,"Macaque",1,60573791
"chr7:137987334:<DEL>:1065:65731.44","<DEL>","chr7",137987334,1065,"Macaque",1,137988399
"chr4:143637296:<DEL>:3462:29571.93","<DEL>","chr4",143637296,3462,"Macaque",1,143640758
"chr12:6975507:<DEL>:595:13281.54","<DEL>","chr12",6975507,595,"Macaque",1,6976102
"chr20:51455959:<DEL>:260:33967.27","<DEL>","chr20",51455959,260,"Macaque",1,51456219
"chr9:11329721:<DEL>:1105:49335.89","<DEL>","chr9",11329721,1105,"Macaque",1,11330826
"chr5:3640487:<DEL>:5922:34201.26","<DEL>","chr5",3640487,5922,"Macaque",1,3646409
"chrX:144614935:<DEL>:2609:15343.5","<DEL>","chrX",144614935,2609,"Macaque",1,144617544
"chr18:16710513:<DEL>:781:15477.88","<DEL>","chr18",16710513,781,"Macaque",1,16711294
"chr8:8185301:<DEL>:617:44518.22","<DEL>","chr8",8185301,617,"Macaque",1,8185918
"chr14:119624776:<DUP>:507:10959.98","<DUP>","chr14",119624776,507,"Macaque",1,119625283
"chr14:864270:<DUP>:1234:20512.36","<DUP>","chr14",864270,1234,"Macaque",1,865504
"chr11:131314818:<DEL>:36450:40473.08","<DEL>","chr11",131314818,36450,"Macaque",1,131351268
"chr10:91509351:<DEL>:604:14114.1","<DEL>","chr10",91509351,604,"Macaque",1,91509955
"chr15:31835197:<DEL>:732:8830.98","<DEL>","chr15",31835197,732,"Macaque",1,31835929
"chr6:92355202:<DEL>:482:33744.19","<DEL>","chr6",92355202,482,"Macaque",1,92355684
"chr6:49743908:<DEL>:481:52453.82","<DEL>","chr6",49743908,481,"Macaque",1,49744389
"chr2:145210566:<DEL>:1771:46744.14","<DEL>","chr2",145210566,1771,"Macaque",1,145212337
"chr14:32090043:<DUP>:302:9399.2","<DUP>","chr14",32090043,302,"Macaque",1,32090345
"chr20:51403743:<DEL>:486:10339.42","<DEL>","chr20",51403743,486,"Macaque",1,51404229
"chr5:135725131:<DEL>:34245:49247.2","<DEL>","chr5",135725131,34245,"Macaque",1,135759376
"chr4:57837509:<DEL>:1413:14623.55","<DEL>","chr4",57837509,1413,"Macaque",1,57838922
"chr3:80166630:<DEL>:6155:11161.27","<DEL>","chr3",80166630,6155,"Macaque",1,80172785
"chrX:55029174:<DEL>:798:12113.98","<DEL>","chrX",55029174,798,"Macaque",1,55029972
"chr9:119840427:<DEL>:466:45858.32","<DEL>","chr9",119840427,466,"Macaque",1,119840893
"chr10:92368769:<DEL>:1832:41536.64","<DEL>","chr10",92368769,1832,"Macaque",1,92370601
"chr7:10452326:<DEL>:49805:37080.52","<DEL>","chr7",10452326,49805,"Macaque",1,10502131
"chr12:3820:<DEL>:1507:12349.53","<DEL>","chr12",3820,1507,"Macaque",1,5327
"chr4:87803933:<DEL>:46225:40916.27","<DEL>","chr4",87803933,46225,"Macaque",1,87850158
"chr14:85258274:<DEL>:803:44697.66","<DEL>","chr14",85258274,803,"Macaque",1,85259077
"chr11:113514249:<DEL>:1444:21536.47","<DEL>","chr11",113514249,1444,"Macaque",1,113515693
"chr13:15075472:<DEL>:607:11873.48","<DEL>","chr13",15075472,607,"Macaque",1,15076079
"chr15:109853160:<DEL>:1374:18228.48","<DEL>","chr15",109853160,1374,"Macaque",1,109854534
"chr5:188644762:<DEL>:919:39626.41","<DEL>","chr5",188644762,919,"Macaque",1,188645681
"chr15:63287438:<DEL>:9434:11099.22","<DEL>","chr15",63287438,9434,"Macaque",1,63296872
"chr15:9070427:<DEL>:668:41608.01","<DEL>","chr15",9070427,668,"Macaque",1,9071095
"chr14:346214:<DEL>:750:39960.92","<DEL>","chr14",346214,750,"Macaque",1,346964
"chr6:92304247:<DEL>:1882:51315.18","<DEL>","chr6",92304247,1882,"Macaque",1,92306129
"chr15:79072707:<DEL>:2813:47811.43","<DEL>","chr15",79072707,2813,"Macaque",1,79075520
"chr7:164560788:<DEL>:771:16485.65","<DEL>","chr7",164560788,771,"Macaque",1,164561559
"chr15:27847195:<DEL>:45802:9671.66","<DEL>","chr15",27847195,45802,"Macaque",1,27892997
"chr15:45507420:<DEL>:1301:23640.69","<DEL>","chr15",45507420,1301,"Macaque",1,45508721
"chr16:58251183:<DEL>:877:24797.94","<DEL>","chr16",58251183,877,"Macaque",1,58252060
"chr15:73575076:<DEL>:410:33227.99","<DEL>","chr15",73575076,410,"Macaque",1,73575486
"chr6:11248976:<DEL>:884:4059.49","<DEL>","chr6",11248976,884,"Macaque",1,11249860
"chr4:102204168:<DEL>:726:32797.88","<DEL>","chr4",102204168,726,"Macaque",1,102204894
"chr8:65665377:<DEL>:6357:28742.83","<DEL>","chr8",65665377,6357,"Macaque",1,65671734
"chr13:2689458:<DEL>:1189:50999.8","<DEL>","chr13",2689458,1189,"Macaque",1,2690647
"chr9:128652994:<DUP>:473:5732.07","<DUP>","chr9",128652994,473,"Macaque",1,128653467
"chr1:75579813:<DEL>:523:20297.67","<DEL>","chr1",75579813,523,"Macaque",1,75580336
"chr13:67381957:<DEL>:321:41753.64","<DEL>","chr13",67381957,321,"Macaque",1,67382278
"chrX:8532999:<DEL>:385:18326.93","<DEL>","chrX",8532999,385,"Macaque",1,8533384
"chr8:141422980:<DEL>:1947:78760.09","<DEL>","chr8",141422980,1947,"Macaque",1,141424927
"chr6:1464374:<DEL>:485:35503.32","<DEL>","chr6",1464374,485,"Macaque",1,1464859
"chrX:109682934:<DEL>:480:46499.34","<DEL>","chrX",109682934,480,"Macaque",1,109683414
"chr10:91209662:<DUP>:593:9604.04","<DUP>","chr10",91209662,593,"Macaque",1,91210255
"chr13:47192737:<DEL>:714:11789.08","<DEL>","chr13",47192737,714,"Macaque",1,47193451
"chr8:112241653:<DEL>:2628:26940.41","<DEL>","chr8",112241653,2628,"Macaque",1,112244281
"chr13:27111912:<DEL>:276:41700.25","<DEL>","chr13",27111912,276,"Macaque",1,27112188
"chr4:161204840:<DEL>:253:13623.2","<DEL>","chr4",161204840,253,"Macaque",1,161205093
"chr2:13944857:<DEL>:705:13189.67","<DEL>","chr2",13944857,705,"Macaque",1,13945562
"chr11:54415375:<DEL>:819:24324.63","<DEL>","chr11",54415375,819,"Macaque",1,54416194
"chr1:8502584:<DEL>:742:17174.02","<DEL>","chr1",8502584,742,"Macaque",1,8503326
"chr9:101670719:<DEL>:6208:26960.0","<DEL>","chr9",101670719,6208,"Macaque",1,101676927
"chrX:774076:<DEL>:6234:15137.31","<DEL>","chrX",774076,6234,"Macaque",1,780310
"chr11:127917237:<DEL>:2782:31137.73","<DEL>","chr11",127917237,2782,"Macaque",1,127920019
"chr3:2491639:<DEL>:800:20709.26","<DEL>","chr3",2491639,800,"Macaque",1,2492439
"chr1:174395721:<DEL>:57756:36877.27","<DEL>","chr1",174395721,57756,"Macaque",1,174453477
"chr4:116466549:<DEL>:12516:18800.66","<DEL>","chr4",116466549,12516,"Macaque",1,116479065
"chr3:34051476:<DEL>:673:17062.81","<DEL>","chr3",34051476,673,"Macaque",1,34052149
"chr10:61438303:<DEL>:2844:20704.49","<DEL>","chr10",61438303,2844,"Macaque",1,61441147
"chr9:93552418:<DEL>:448:25122.54","<DEL>","chr9",93552418,448,"Macaque",1,93552866
"chr1:14915572:<DEL>:891:51256.1","<DEL>","chr1",14915572,891,"Macaque",1,14916463
"chr1:33994577:<DEL>:369:22161.93","<DEL>","chr1",33994577,369,"Macaque",1,33994946
"chr2:85631925:<DEL>:1535:18326.81","<DEL>","chr2",85631925,1535,"Macaque",1,85633460
"chr5:3654764:<DUP>:404:6308.44","<DUP>","chr5",3654764,404,"Macaque",1,3655168
"chr12:100096162:<DEL>:1907:29886.95","<DEL>","chr12",100096162,1907,"Macaque",1,100098069
"chr8:119275436:<DEL>:521:43659.3","<DEL>","chr8",119275436,521,"Macaque",1,119275957
"chr3:126388212:<DEL>:6035:12662.8","<DEL>","chr3",126388212,6035,"Macaque",1,126394247
"chr13:4204269:<DEL>:427:15791.87","<DEL>","chr13",4204269,427,"Macaque",1,4204696
"chr16:2778129:<DEL>:3409:48598.84","<DEL>","chr16",2778129,3409,"Macaque",1,2781538
"chr14:1026150:<DUP>:1612:5253.72","<DUP>","chr14",1026150,1612,"Macaque",1,1027762
"chr16:1553037:<DEL>:766:8068.47","<DEL>","chr16",1553037,766,"Macaque",1,1553803
"chr19:2758370:<DEL>:988:11715.97","<DEL>","chr19",2758370,988,"Macaque",1,2759358
"chr15:26551870:<DEL>:1714:32423.01","<DEL>","chr15",26551870,1714,"Macaque",1,26553584
"chr16:53715131:<DEL>:1730:32703.45","<DEL>","chr16",53715131,1730,"Macaque",1,53716861
"chr8:108550167:<DEL>:692:45308.08","<DEL>","chr8",108550167,692,"Macaque",1,108550859
"chr6:38103834:<DEL>:784:27740.34","<DEL>","chr6",38103834,784,"Macaque",1,38104618
"chr14:25035341:<DEL>:1306:61773.22","<DEL>","chr14",25035341,1306,"Macaque",1,25036647
"chr4:23040626:<DEL>:651:39645.48","<DEL>","chr4",23040626,651,"Macaque",1,23041277
"chr8:141802396:<DUP>:818:8906.55","<DUP>","chr8",141802396,818,"Macaque",1,141803214
"chr19:42867300:<DEL>:728:11450.73","<DEL>","chr19",42867300,728,"Macaque",1,42868028
"chr10:88309148:<DEL>:1715:31758.12","<DEL>","chr10",88309148,1715,"Macaque",1,88310863
"chrX:2897184:<DEL>:5438:24211.84","<DEL>","chrX",2897184,5438,"Macaque",1,2902622
"chr7:13831977:<DEL>:669:6435.5","<DEL>","chr7",13831977,669,"Macaque",1,13832646
"chr1:32756200:<DEL>:2569:30588.36","<DEL>","chr1",32756200,2569,"Macaque",1,32758769
"chr1:153932769:<DEL>:1220:26833.55","<DEL>","chr1",153932769,1220,"Macaque",1,153933989
"chr14:81706414:<DEL>:3360:36573.52","<DEL>","chr14",81706414,3360,"Macaque",1,81709774
"chr11:77458719:<DEL>:1931:25524.67","<DEL>","chr11",77458719,1931,"Macaque",1,77460650
"chr8:103663538:<DEL>:404:15569.45","<DEL>","chr8",103663538,404,"Macaque",1,103663942
"chr18:64067568:<DEL>:966:27556.91","<DEL>","chr18",64067568,966,"Macaque",1,64068534
"chr3:8014908:<DEL>:4801:38198.37","<DEL>","chr3",8014908,4801,"Macaque",1,8019709
"chr15:36825565:<DEL>:5456:33796.55","<DEL>","chr15",36825565,5456,"Macaque",1,36831021
"chr19:3813807:<DEL>:643:52294.3","<DEL>","chr19",3813807,643,"Macaque",1,3814450
"chr10:58199870:<DEL>:1324:36524.48","<DEL>","chr10",58199870,1324,"Macaque",1,58201194
"chr12:10203443:<DEL>:5598:17528.73","<DEL>","chr12",10203443,5598,"Macaque",1,10209041
"chr18:48232336:<DEL>:697:16042.38","<DEL>","chr18",48232336,697,"Macaque",1,48233033
"chr3:170023192:<DEL>:7069:58139.49","<DEL>","chr3",170023192,7069,"Macaque",1,170030261
"chr9:3404134:<DEL>:30153:8614.25","<DEL>","chr9",3404134,30153,"Macaque",1,3434287
"chr12:15577735:<DEL>:43174:41211.68","<DEL>","chr12",15577735,43174,"Macaque",1,15620909
"chr1:214323612:<DEL>:3222:45997.55","<DEL>","chr1",214323612,3222,"Macaque",1,214326834
"chr10:28904467:<DEL>:1142:16014.35","<DEL>","chr10",28904467,1142,"Macaque",1,28905609
"chr11:11983500:<DEL>:61926:28955.1","<DEL>","chr11",11983500,61926,"Macaque",1,12045426
"chr11:133347398:<DEL>:637:16674.08","<DEL>","chr11",133347398,637,"Macaque",1,133348035
"chr9:46111369:<DEL>:979:35923.6","<DEL>","chr9",46111369,979,"Macaque",1,46112348
"chr10:2015205:<DEL>:503:19185.14","<DEL>","chr10",2015205,503,"Macaque",1,2015708
"chrX:124908568:<DEL>:1029:12566.41","<DEL>","chrX",124908568,1029,"Macaque",1,124909597
"chr15:32860733:<DEL>:1852:20901.96","<DEL>","chr15",32860733,1852,"Macaque",1,32862585
"chr16:33082572:<DEL>:519:14919.2","<DEL>","chr16",33082572,519,"Macaque",1,33083091
"chr5:154913162:<DEL>:445:10325.83","<DEL>","chr5",154913162,445,"Macaque",1,154913607
"chr1:125441991:<DEL>:757:62511.78","<DEL>","chr1",125441991,757,"Macaque",1,125442748
"chr19:276162:<DEL>:1191:18719.11","<DEL>","chr19",276162,1191,"Macaque",1,277353
"chr20:39899955:<DUP>:423:4208.29","<DUP>","chr20",39899955,423,"Macaque",1,39900378
"chr4:31855902:<DEL>:1300:12477.18","<DEL>","chr4",31855902,1300,"Macaque",1,31857202
"chr19:7197420:<DEL>:3251:14598.35","<DEL>","chr19",7197420,3251,"Macaque",1,7200671
"chr3:29615430:<DEL>:533:15825.38","<DEL>","chr3",29615430,533,"Macaque",1,29615963
"chr19:42122168:<DEL>:309:29341.35","<DEL>","chr19",42122168,309,"Macaque",1,42122477
"chr6:24642320:<DEL>:336:28368.77","<DEL>","chr6",24642320,336,"Macaque",1,24642656
"chr2:67767961:<DEL>:66974:26193.99","<DEL>","chr2",67767961,66974,"Macaque",1,67834935
"chr3:124423517:<DEL>:402:23204.78","<DEL>","chr3",124423517,402,"Macaque",1,124423919
"chr19:34375126:<DEL>:835:69443.81","<DEL>","chr19",34375126,835,"Macaque",1,34375961
"chr2:163001124:<DEL>:10039:20502.44","<DEL>","chr2",163001124,10039,"Macaque",1,163011163
"chr12:56752317:<DEL>:1567:29356.6","<DEL>","chr12",56752317,1567,"Macaque",1,56753884
"chr20:67636907:<DEL>:1491:49188.13","<DEL>","chr20",67636907,1491,"Macaque",1,67638398
"chr2:195875984:<DEL>:756:10445.8","<DEL>","chr2",195875984,756,"Macaque",1,195876740
"chr13:68245844:<DEL>:62305:48863.17","<DEL>","chr13",68245844,62305,"Macaque",1,68308149
"chr9:13515355:<DEL>:485:74270.87","<DEL>","chr9",13515355,485,"Macaque",1,13515840
"chr3:3128377:<DEL>:751:10773.88","<DEL>","chr3",3128377,751,"Macaque",1,3129128
"chr15:49613429:<DEL>:487:50818.29","<DEL>","chr15",49613429,487,"Macaque",1,49613916
"chr4:38279189:<DEL>:555:23330.76","<DEL>","chr4",38279189,555,"Macaque",1,38279744
"chr1:1064566:<DEL>:1337:73058.43","<DEL>","chr1",1064566,1337,"Macaque",1,1065903
"chr8:3567759:<DEL>:735:4796.94","<DEL>","chr8",3567759,735,"Macaque",1,3568494
"chr11:68464344:<DEL>:788:19252.47","<DEL>","chr11",68464344,788,"Macaque",1,68465132
"chr19:4160274:<DEL>:857:46243.03","<DEL>","chr19",4160274,857,"Macaque",1,4161131
"chr19:45677599:<DEL>:1680:58500.89","<DEL>","chr19",45677599,1680,"Macaque",1,45679279
"chr13:61074014:<DEL>:484:38036.2","<DEL>","chr13",61074014,484,"Macaque",1,61074498
"chr13:75958263:<DEL>:1508:37398.93","<DEL>","chr13",75958263,1508,"Macaque",1,75959771
"chr9:26690797:<DEL>:8480:10003.65","<DEL>","chr9",26690797,8480,"Macaque",1,26699277
"chr13:105748177:<DEL>:433:12336.23","<DEL>","chr13",105748177,433,"Macaque",1,105748610
"chr7:161919137:<DEL>:628:12839.92","<DEL>","chr7",161919137,628,"Macaque",1,161919765
"chrX:147300645:<DEL>:511:34931.57","<DEL>","chrX",147300645,511,"Macaque",1,147301156
"chr20:1510674:<DUP>:711:10753.52","<DUP>","chr20",1510674,711,"Macaque",1,1511385
"chr15:97271352:<DEL>:394:14072.15","<DEL>","chr15",97271352,394,"Macaque",1,97271746
"chr9:30767165:<DEL>:1992:9502.38","<DEL>","chr9",30767165,1992,"Macaque",1,30769157
"chr2:14596917:<DEL>:1801:24711.78","<DEL>","chr2",14596917,1801,"Macaque",1,14598718
"chr11:110284269:<DEL>:722:20973.14","<DEL>","chr11",110284269,722,"Macaque",1,110284991
"chr2:13335793:<DEL>:8216:9988.41","<DEL>","chr2",13335793,8216,"Macaque",1,13344009
"chr10:65499056:<DEL>:908:32762.55","<DEL>","chr10",65499056,908,"Macaque",1,65499964
"chrX:939034:<DEL>:717:7222.75","<DEL>","chrX",939034,717,"Macaque",1,939751
"chr12:94066295:<DEL>:4635:41727.7","<DEL>","chr12",94066295,4635,"Macaque",1,94070930
"chr3:51359724:<DEL>:56211:55480.69","<DEL>","chr3",51359724,56211,"Macaque",1,51415935
"chr14:9531510:<DEL>:538:71166.8","<DEL>","chr14",9531510,538,"Macaque",1,9532048
"chr14:274566:<DEL>:539:12598.92","<DEL>","chr14",274566,539,"Macaque",1,275105
"chr2:151628948:<DEL>:671:41773.01","<DEL>","chr2",151628948,671,"Macaque",1,151629619
"chr1:1066617:<DEL>:1223:32371.84","<DEL>","chr1",1066617,1223,"Macaque",1,1067840
"chr7:147719001:<DEL>:4850:16184.36","<DEL>","chr7",147719001,4850,"Macaque",1,147723851
"chr18:65175047:<DEL>:26251:18357.95","<DEL>","chr18",65175047,26251,"Macaque",1,65201298
"chr14:60581727:<DEL>:931:21270.54","<DEL>","chr14",60581727,931,"Macaque",1,60582658
"chr19:4703066:<DEL>:620:49679.92","<DEL>","chr19",4703066,620,"Macaque",1,4703686
"chr2:122088559:<DEL>:335:23655.13","<DEL>","chr2",122088559,335,"Macaque",1,122088894
"chr10:38113535:<DEL>:1034:20827.42","<DEL>","chr10",38113535,1034,"Macaque",1,38114569
"chr19:7657561:<DEL>:3102:17666.43","<DEL>","chr19",7657561,3102,"Macaque",1,7660663
"chr3:24395775:<DEL>:1474:23089.12","<DEL>","chr3",24395775,1474,"Macaque",1,24397249
"chr13:48979991:<DUP>:1145:15254.51","<DUP>","chr13",48979991,1145,"Macaque",1,48981136
"chr14:11759543:<DEL>:1416:45495.34","<DEL>","chr14",11759543,1416,"Macaque",1,11760959
"chr15:54405568:<DEL>:1047:30271.15","<DEL>","chr15",54405568,1047,"Macaque",1,54406615
"chr6:102377334:<DEL>:1394:6690.21","<DEL>","chr6",102377334,1394,"Macaque",1,102378728
"chr11:100645225:<DEL>:2123:6287.67","<DEL>","chr11",100645225,2123,"Macaque",1,100647348
"chr1:156839864:<DEL>:34389:68774.75","<DEL>","chr1",156839864,34389,"Macaque",1,156874253
"chr6:128694907:<DEL>:770:46677.02","<DEL>","chr6",128694907,770,"Macaque",1,128695677
"chr12:94486474:<DEL>:627:13670.75","<DEL>","chr12",94486474,627,"Macaque",1,94487101
"chr10:32030639:<DEL>:1959:39232.32","<DEL>","chr10",32030639,1959,"Macaque",1,32032598
"chr11:132156722:<DEL>:1256:11544.25","<DEL>","chr11",132156722,1256,"Macaque",1,132157978
"chr13:93724819:<DEL>:1177:30576.41","<DEL>","chr13",93724819,1177,"Macaque",1,93725996
"chr1:1162938:<DUP>:615:11281.6","<DUP>","chr1",1162938,615,"Macaque",1,1163553
"chr7:164757436:<DEL>:403:50010.64","<DEL>","chr7",164757436,403,"Macaque",1,164757839
"chrX:143379684:<DEL>:2919:14735.71","<DEL>","chrX",143379684,2919,"Macaque",1,143382603
"chr16:68056286:<DEL>:703:31314.98","<DEL>","chr16",68056286,703,"Macaque",1,68056989
"chr1:76392205:<DEL>:28459:40713.4","<DEL>","chr1",76392205,28459,"Macaque",1,76420664
"chr4:98119127:<DEL>:592:20885.08","<DEL>","chr4",98119127,592,"Macaque",1,98119719
"chr12:19929647:<DUP>:811:15915.82","<DUP>","chr12",19929647,811,"Macaque",1,19930458
"chr19:13303765:<DEL>:4660:27817.11","<DEL>","chr19",13303765,4660,"Macaque",1,13308425
"chr4:87804614:<DEL>:46383:32040.36","<DEL>","chr4",87804614,46383,"Macaque",1,87850997
"chr8:99807924:<DEL>:2607:36380.93","<DEL>","chr8",99807924,2607,"Macaque",1,99810531
"chr11:22261707:<DEL>:1923:8410.42","<DEL>","chr11",22261707,1923,"Macaque",1,22263630
"chr14:97777956:<DEL>:1715:16780.18","<DEL>","chr14",97777956,1715,"Macaque",1,97779671
"chr9:76851561:<DEL>:675:28331.23","<DEL>","chr9",76851561,675,"Macaque",1,76852236
"chr20:55086791:<DEL>:1092:25893.61","<DEL>","chr20",55086791,1092,"Macaque",1,55087883
"chr4:40922144:<DEL>:406:36573.5","<DEL>","chr4",40922144,406,"Macaque",1,40922550
"chr10:64572489:<DEL>:1499:30232.18","<DEL>","chr10",64572489,1499,"Macaque",1,64573988
"chr5:102538151:<DEL>:39214:48095.07","<DEL>","chr5",102538151,39214,"Macaque",1,102577365
"chr11:12987273:<DEL>:972:19409.42","<DEL>","chr11",12987273,972,"Macaque",1,12988245
"chr3:185491590:<DEL>:41357:22540.9","<DEL>","chr3",185491590,41357,"Macaque",1,185532947
"chr2:47763645:<DEL>:1479:14245.56","<DEL>","chr2",47763645,1479,"Macaque",1,47765124
"chr4:162817891:<DEL>:3202:28183.47","<DEL>","chr4",162817891,3202,"Macaque",1,162821093
"chr10:79574113:<DEL>:1000:30111.09","<DEL>","chr10",79574113,1000,"Macaque",1,79575113
"chr17:14594743:<DEL>:47245:19705.48","<DEL>","chr17",14594743,47245,"Macaque",1,14641988
"chr14:125646951:<DEL>:36384:16573.48","<DEL>","chr14",125646951,36384,"Macaque",1,125683335
"chr16:4953236:<DEL>:1137:56026.92","<DEL>","chr16",4953236,1137,"Macaque",1,4954373
"chr5:171255796:<DEL>:432:17104.73","<DEL>","chr5",171255796,432,"Macaque",1,171256228
"chr9:120593302:<DEL>:465:49794.53","<DEL>","chr9",120593302,465,"Macaque",1,120593767
"chr16:11405592:<DEL>:42502:22570.46","<DEL>","chr16",11405592,42502,"Macaque",1,11448094
"chr15:2576305:<DEL>:2175:6478.68","<DEL>","chr15",2576305,2175,"Macaque",1,2578480
"chr5:65485990:<DEL>:77532:16136.31","<DEL>","chr5",65485990,77532,"Macaque",1,65563522
"chr9:46033613:<DEL>:645:39882.26","<DEL>","chr9",46033613,645,"Macaque",1,46034258
"chr14:10842570:<DEL>:584:20241.39","<DEL>","chr14",10842570,584,"Macaque",1,10843154
"chr1:210377745:<DUP>:721:16930.83","<DUP>","chr1",210377745,721,"Macaque",1,210378466
"chr10:13985705:<DEL>:653:27835.18","<DEL>","chr10",13985705,653,"Macaque",1,13986358
"chr14:10205164:<DEL>:561:8286.79","<DEL>","chr14",10205164,561,"Macaque",1,10205725
"chr2:20412817:<DEL>:419:14075.36","<DEL>","chr2",20412817,419,"Macaque",1,20413236
"chrX:18497052:<DEL>:538:10945.48","<DEL>","chrX",18497052,538,"Macaque",1,18497590
"chr12:94070855:<DEL>:4304:52940.04","<DEL>","chr12",94070855,4304,"Macaque",1,94075159
"chr16:51147184:<DEL>:731:40935.38","<DEL>","chr16",51147184,731,"Macaque",1,51147915
"chr15:4181556:<DEL>:2461:9191.04","<DEL>","chr15",4181556,2461,"Macaque",1,4184017
"chr6:1100725:<DUP>:795:61382.92","<DUP>","chr6",1100725,795,"Macaque",1,1101520
"chr10:57844995:<DEL>:74527:24017.55","<DEL>","chr10",57844995,74527,"Macaque",1,57919522
"chr20:73595075:<DEL>:4110:33885.18","<DEL>","chr20",73595075,4110,"Macaque",1,73599185
"chr6:178814196:<DEL>:618:43701.02","<DEL>","chr6",178814196,618,"Macaque",1,178814814
"chr13:25070863:<DEL>:1678:14859.97","<DEL>","chr13",25070863,1678,"Macaque",1,25072541
"chr4:43133663:<DEL>:785:56426.08","<DEL>","chr4",43133663,785,"Macaque",1,43134448
"chr10:79613:<DEL>:841:9529.19","<DEL>","chr10",79613,841,"Macaque",1,80454
"chr15:23445754:<DEL>:2680:17902.87","<DEL>","chr15",23445754,2680,"Macaque",1,23448434
"chr3:150056784:<DEL>:45281:32403.05","<DEL>","chr3",150056784,45281,"Macaque",1,150102065
"chr7:161300775:<DEL>:1268:16845.49","<DEL>","chr7",161300775,1268,"Macaque",1,161302043
"chr10:1355800:<DEL>:3841:40078.17","<DEL>","chr10",1355800,3841,"Macaque",1,1359641
"chr6:175314957:<DEL>:524:10933.84","<DEL>","chr6",175314957,524,"Macaque",1,175315481
"chr7:144335317:<DEL>:50209:23273.45","<DEL>","chr7",144335317,50209,"Macaque",1,144385526
"chr16:50865465:<DEL>:731:45613.52","<DEL>","chr16",50865465,731,"Macaque",1,50866196
"chrX:1323966:<DUP>:449:12246.95","<DUP>","chrX",1323966,449,"Macaque",1,1324415
"chr9:53764849:<DEL>:1970:13800.42","<DEL>","chr9",53764849,1970,"Macaque",1,53766819
"chr9:35936539:<DUP>:367:21275.55","<DUP>","chr9",35936539,367,"Macaque",1,35936906
"chr2:202779082:<DEL>:3661:31787.67","<DEL>","chr2",202779082,3661,"Macaque",1,202782743
"chr10:16805354:<DEL>:828:24523.04","<DEL>","chr10",16805354,828,"Macaque",1,16806182
"chr4:169912256:<DEL>:875:11564.16","<DEL>","chr4",169912256,875,"Macaque",1,169913131
"chr12:29405845:<DEL>:3811:54830.75","<DEL>","chr12",29405845,3811,"Macaque",1,29409656
"chr1:44165137:<DEL>:1362:33952.71","<DEL>","chr1",44165137,1362,"Macaque",1,44166499
"chr13:108511801:<DEL>:20807:24174.01","<DEL>","chr13",108511801,20807,"Macaque",1,108532608
"chr4:38402092:<DEL>:2273:37402.29","<DEL>","chr4",38402092,2273,"Macaque",1,38404365
"chr10:48937922:<DEL>:692:30971.52","<DEL>","chr10",48937922,692,"Macaque",1,48938614
"chr6:28434225:<DEL>:577:35978.74","<DEL>","chr6",28434225,577,"Macaque",1,28434802
"chr8:3414441:<DEL>:42556:15475.47","<DEL>","chr8",3414441,42556,"Macaque",1,3456997
"chr3:179902287:<DEL>:1872:29956.0","<DEL>","chr3",179902287,1872,"Macaque",1,179904159
"chr1:117740134:<DEL>:633:70418.69","<DEL>","chr1",117740134,633,"Macaque",1,117740767
"chrX:25624146:<DEL>:27267:25707.91","<DEL>","chrX",25624146,27267,"Macaque",1,25651413
"chr14:103760906:<DEL>:609:17896.08","<DEL>","chr14",103760906,609,"Macaque",1,103761515
"chr13:91450152:<DEL>:1074:11584.48","<DEL>","chr13",91450152,1074,"Macaque",1,91451226
"chr1:211342311:<DEL>:834:13264.65","<DEL>","chr1",211342311,834,"Macaque",1,211343145
"chr3:89411432:<DEL>:490:15592.03","<DEL>","chr3",89411432,490,"Macaque",1,89411922
"chr2:201882646:<DEL>:594:55734.78","<DEL>","chr2",201882646,594,"Macaque",1,201883240
"chr15:22211362:<DEL>:4793:45274.98","<DEL>","chr15",22211362,4793,"Macaque",1,22216155
"chrX:48683383:<DEL>:1519:30458.25","<DEL>","chrX",48683383,1519,"Macaque",1,48684902
"chr20:58176086:<DEL>:414:16372.49","<DEL>","chr20",58176086,414,"Macaque",1,58176500
"chr6:43737266:<DEL>:7438:35298.95","<DEL>","chr6",43737266,7438,"Macaque",1,43744704
"chr16:21449037:<DEL>:457:33372.51","<DEL>","chr16",21449037,457,"Macaque",1,21449494
"chr20:14423692:<DEL>:5329:24083.67","<DEL>","chr20",14423692,5329,"Macaque",1,14429021
"chr2:149056335:<DEL>:8164:22452.31","<DEL>","chr2",149056335,8164,"Macaque",1,149064499
"chr10:2962396:<DEL>:785:15879.91","<DEL>","chr10",2962396,785,"Macaque",1,2963181
"chr14:84681839:<DEL>:6950:37826.86","<DEL>","chr14",84681839,6950,"Macaque",1,84688789
"chr1:162831034:<DEL>:775:26942.72","<DEL>","chr1",162831034,775,"Macaque",1,162831809
"chr13:7704883:<DEL>:554:73077.97","<DEL>","chr13",7704883,554,"Macaque",1,7705437
"chr5:99206417:<DEL>:989:18096.15","<DEL>","chr5",99206417,989,"Macaque",1,99207406
"chr7:154025109:<DEL>:1164:26560.82","<DEL>","chr7",154025109,1164,"Macaque",1,154026273
"chr11:109597647:<DUP>:373:19489.39","<DUP>","chr11",109597647,373,"Macaque",1,109598020
"chr19:20753443:<DEL>:1303:17877.86","<DEL>","chr19",20753443,1303,"Macaque",1,20754746
"chr10:84657349:<DEL>:544:11668.62","<DEL>","chr10",84657349,544,"Macaque",1,84657893
"chr7:38998254:<DEL>:1352:69561.97","<DEL>","chr7",38998254,1352,"Macaque",1,38999606
"chr13:34619574:<DEL>:1237:46500.91","<DEL>","chr13",34619574,1237,"Macaque",1,34620811
"chr12:101400559:<DEL>:1036:70104.19","<DEL>","chr12",101400559,1036,"Macaque",1,101401595
"chr8:1498250:<DUP>:553:5094.88","<DUP>","chr8",1498250,553,"Macaque",1,1498803
"chr1:32104923:<DEL>:2404:8823.76","<DEL>","chr1",32104923,2404,"Macaque",1,32107327
"chr13:7915730:<DEL>:601:45402.2","<DEL>","chr13",7915730,601,"Macaque",1,7916331
"chr16:48184554:<DEL>:1171:8143.52","<DEL>","chr16",48184554,1171,"Macaque",1,48185725
"chr15:69772387:<DEL>:62636:9243.23","<DEL>","chr15",69772387,62636,"Macaque",1,69835023
"chr3:41989107:<DEL>:2569:73501.56","<DEL>","chr3",41989107,2569,"Macaque",1,41991676
"chr14:1026662:<DEL>:414:10192.59","<DEL>","chr14",1026662,414,"Macaque",1,1027076
"chr6:41852474:<DEL>:1318:34298.77","<DEL>","chr6",41852474,1318,"Macaque",1,41853792
"chr7:6755686:<DUP>:762:15302.97","<DUP>","chr7",6755686,762,"Macaque",1,6756448
"chr13:43149989:<DEL>:2517:10843.35","<DEL>","chr13",43149989,2517,"Macaque",1,43152506
"chr13:81250443:<DEL>:447:12262.35","<DEL>","chr13",81250443,447,"Macaque",1,81250890
"chr8:21685635:<DEL>:560:20429.9","<DEL>","chr8",21685635,560,"Macaque",1,21686195
"chr7:159203803:<DEL>:369:19152.24","<DEL>","chr7",159203803,369,"Macaque",1,159204172
"chr4:169090256:<DEL>:659:8637.63","<DEL>","chr4",169090256,659,"Macaque",1,169090915
"chr16:3833791:<DEL>:590:53579.53","<DEL>","chr16",3833791,590,"Macaque",1,3834381
"chr19:3324281:<DEL>:1393:27612.79","<DEL>","chr19",3324281,1393,"Macaque",1,3325674
"chr5:169096891:<DEL>:2445:32733.0","<DEL>","chr5",169096891,2445,"Macaque",1,169099336
"chr12:120904527:<DEL>:548:19552.76","<DEL>","chr12",120904527,548,"Macaque",1,120905075
"chr10:58888458:<DUP>:3906:17886.38","<DUP>","chr10",58888458,3906,"Macaque",1,58892364
"chr17:93259910:<DEL>:742:7557.86","<DEL>","chr17",93259910,742,"Macaque",1,93260652
"chr18:8902554:<DEL>:590:47917.83","<DEL>","chr18",8902554,590,"Macaque",1,8903144
"chr16:75759835:<DEL>:1091:16307.48","<DEL>","chr16",75759835,1091,"Macaque",1,75760926
"chr1:209552756:<DEL>:1575:8601.15","<DEL>","chr1",209552756,1575,"Macaque",1,209554331
"chr10:886711:<DEL>:577:70163.26","<DEL>","chr10",886711,577,"Macaque",1,887288
"chr2:65196111:<DEL>:770:16312.16","<DEL>","chr2",65196111,770,"Macaque",1,65196881
"chrX:39470386:<DEL>:798:29890.43","<DEL>","chrX",39470386,798,"Macaque",1,39471184
"chr12:114877865:<DEL>:39663:8147.11","<DEL>","chr12",114877865,39663,"Macaque",1,114917528
"chr5:65485966:<DEL>:77170:13002.97","<DEL>","chr5",65485966,77170,"Macaque",1,65563136
"chr16:4953606:<DEL>:769:73915.12","<DEL>","chr16",4953606,769,"Macaque",1,4954375
"chr6:113056963:<DEL>:47461:56573.76","<DEL>","chr6",113056963,47461,"Macaque",1,113104424
"chr16:44109862:<DEL>:684:52701.93","<DEL>","chr16",44109862,684,"Macaque",1,44110546
"chr7:26554471:<DEL>:657:29217.46","<DEL>","chr7",26554471,657,"Macaque",1,26555128
"chr15:6086645:<DEL>:2531:5108.24","<DEL>","chr15",6086645,2531,"Macaque",1,6089176
"chr10:85679257:<DEL>:1214:36075.95","<DEL>","chr10",85679257,1214,"Macaque",1,85680471
"chr8:114797977:<DEL>:316:24923.88","<DEL>","chr8",114797977,316,"Macaque",1,114798293
"chrX:128836591:<DEL>:952:13275.6","<DEL>","chrX",128836591,952,"Macaque",1,128837543
"chr3:138604279:<DEL>:6249:36690.35","<DEL>","chr3",138604279,6249,"Macaque",1,138610528
"chr4:169421269:<DEL>:10834:27120.0","<DEL>","chr4",169421269,10834,"Macaque",1,169432103
"chr18:56228712:<DEL>:474:8794.7","<DEL>","chr18",56228712,474,"Macaque",1,56229186
"chr5:1658628:<DEL>:585:30006.4","<DEL>","chr5",1658628,585,"Macaque",1,1659213
"chr1:137585521:<DEL>:824:19221.65","<DEL>","chr1",137585521,824,"Macaque",1,137586345
"chr16:16045078:<DUP>:5123:4549.01","<DUP>","chr16",16045078,5123,"Macaque",1,16050201
"chr2:116256561:<DEL>:5253:19078.63","<DEL>","chr2",116256561,5253,"Macaque",1,116261814
"chr10:78201062:<DEL>:801:12088.69","<DEL>","chr10",78201062,801,"Macaque",1,78201863
"chrX:95303241:<DEL>:1046:18192.56","<DEL>","chrX",95303241,1046,"Macaque",1,95304287
"chr20:9217292:<DEL>:995:56071.55","<DEL>","chr20",9217292,995,"Macaque",1,9218287
"chr1:30448253:<DEL>:996:19409.39","<DEL>","chr1",30448253,996,"Macaque",1,30449249
"chrX:39904866:<DEL>:691:45170.39","<DEL>","chrX",39904866,691,"Macaque",1,39905557
"chr4:45695594:<DEL>:761:32639.21","<DEL>","chr4",45695594,761,"Macaque",1,45696355
"chr3:151759111:<DEL>:1370:17130.99","<DEL>","chr3",151759111,1370,"Macaque",1,151760481
"chr10:86183731:<DEL>:296:31815.37","<DEL>","chr10",86183731,296,"Macaque",1,86184027
"chr12:123813284:<DEL>:778:63663.9","<DEL>","chr12",123813284,778,"Macaque",1,123814062
"chr10:64572736:<DEL>:1253:30021.82","<DEL>","chr10",64572736,1253,"Macaque",1,64573989
"chr9:547254:<DEL>:1741:16253.28","<DEL>","chr9",547254,1741,"Macaque",1,548995
"chr3:138634036:<DEL>:3036:55687.44","<DEL>","chr3",138634036,3036,"Macaque",1,138637072
"chr10:1262921:<DEL>:1126:26617.76","<DEL>","chr10",1262921,1126,"Macaque",1,1264047
"chr15:28851399:<DEL>:3572:56987.35","<DEL>","chr15",28851399,3572,"Macaque",1,28854971
"chr1:9066929:<DEL>:309:48021.19","<DEL>","chr1",9066929,309,"Macaque",1,9067238
"chr8:140466366:<DEL>:846:42871.8","<DEL>","chr8",140466366,846,"Macaque",1,140467212
"chr6:78524629:<DEL>:393:19136.58","<DEL>","chr6",78524629,393,"Macaque",1,78525022
"chr8:121000635:<DEL>:3990:43663.69","<DEL>","chr8",121000635,3990,"Macaque",1,121004625
"chr8:102624333:<DEL>:1382:21331.18","<DEL>","chr8",102624333,1382,"Macaque",1,102625715
"chr1:18702228:<DEL>:327:26506.52","<DEL>","chr1",18702228,327,"Macaque",1,18702555
"chr4:34914239:<DEL>:870:8164.35","<DEL>","chr4",34914239,870,"Macaque",1,34915109
"chr4:33776217:<DEL>:802:22981.01","<DEL>","chr4",33776217,802,"Macaque",1,33777019
"chr15:14215952:<DEL>:763:67327.18","<DEL>","chr15",14215952,763,"Macaque",1,14216715
"chr6:63106427:<DEL>:3269:8243.41","<DEL>","chr6",63106427,3269,"Macaque",1,63109696
"chr15:110792419:<DEL>:526:37561.81","<DEL>","chr15",110792419,526,"Macaque",1,110792945
"chr12:122105834:<DEL>:1384:25347.4","<DEL>","chr12",122105834,1384,"Macaque",1,122107218
"chr12:34014502:<DEL>:761:26434.91","<DEL>","chr12",34014502,761,"Macaque",1,34015263
"chr16:76380842:<DEL>:479:9224.08","<DEL>","chr16",76380842,479,"Macaque",1,76381321
"chr3:185491845:<DEL>:43426:47120.18","<DEL>","chr3",185491845,43426,"Macaque",1,185535271
"chr13:581687:<DEL>:23388:37341.6","<DEL>","chr13",581687,23388,"Macaque",1,605075
"chr13:82562485:<DEL>:3827:21869.19","<DEL>","chr13",82562485,3827,"Macaque",1,82566312
"chr4:149567214:<DEL>:57641:23840.75","<DEL>","chr4",149567214,57641,"Macaque",1,149624855
"chr1:192231055:<DEL>:563:17548.52","<DEL>","chr1",192231055,563,"Macaque",1,192231618
"chrX:100376272:<DEL>:785:11003.62","<DEL>","chrX",100376272,785,"Macaque",1,100377057
"chr3:162108182:<DEL>:1141:54535.33","<DEL>","chr3",162108182,1141,"Macaque",1,162109323
"chr11:55314120:<DEL>:1671:39936.44","<DEL>","chr11",55314120,1671,"Macaque",1,55315791
"chr7:27424417:<DEL>:1292:17246.8","<DEL>","chr7",27424417,1292,"Macaque",1,27425709
"chr1:129343343:<DEL>:53785:68952.02","<DEL>","chr1",129343343,53785,"Macaque",1,129397128
"chr17:12305353:<DEL>:31975:11909.9","<DEL>","chr17",12305353,31975,"Macaque",1,12337328
"chr2:30203894:<DEL>:684:8848.28","<DEL>","chr2",30203894,684,"Macaque",1,30204578
"chr2:48211364:<DUP>:1099:8088.89","<DUP>","chr2",48211364,1099,"Macaque",1,48212463
"chr3:123490933:<DEL>:430:19782.4","<DEL>","chr3",123490933,430,"Macaque",1,123491363
"chr11:15455513:<DEL>:684:14937.09","<DEL>","chr11",15455513,684,"Macaque",1,15456197
"chr15:72608435:<DEL>:38296:23234.52","<DEL>","chr15",72608435,38296,"Macaque",1,72646731
"chr3:75237683:<DEL>:2807:19484.86","<DEL>","chr3",75237683,2807,"Macaque",1,75240490
"chr14:114321668:<DEL>:3051:49483.55","<DEL>","chr14",114321668,3051,"Macaque",1,114324719
"chr1:16151741:<DEL>:678:61920.93","<DEL>","chr1",16151741,678,"Macaque",1,16152419
"chr14:103823065:<DEL>:425:17925.01","<DEL>","chr14",103823065,425,"Macaque",1,103823490
"chr17:59944023:<DEL>:1370:41201.65","<DEL>","chr17",59944023,1370,"Macaque",1,59945393
"chrX:20034552:<DEL>:586:50586.18","<DEL>","chrX",20034552,586,"Macaque",1,20035138
"chr16:68051386:<DEL>:4560:32319.43","<DEL>","chr16",68051386,4560,"Macaque",1,68055946
"chr7:125678609:<DEL>:667:43513.07","<DEL>","chr7",125678609,667,"Macaque",1,125679276
"chr11:103146317:<DEL>:990:13193.81","<DEL>","chr11",103146317,990,"Macaque",1,103147307
"chr11:11003286:<DEL>:1442:36159.92","<DEL>","chr11",11003286,1442,"Macaque",1,11004728
"chr10:32497591:<DEL>:838:18429.54","<DEL>","chr10",32497591,838,"Macaque",1,32498429
"chr14:103047706:<DEL>:346:18250.11","<DEL>","chr14",103047706,346,"Macaque",1,103048052
"chr4:18617566:<DEL>:10906:24963.38","<DEL>","chr4",18617566,10906,"Macaque",1,18628472
"chr8:96885190:<DEL>:724:29985.57","<DEL>","chr8",96885190,724,"Macaque",1,96885914
"chr5:161965660:<DEL>:362:16998.37","<DEL>","chr5",161965660,362,"Macaque",1,161966022
"chr8:26282682:<DEL>:2377:66027.29","<DEL>","chr8",26282682,2377,"Macaque",1,26285059
"chr1:139066448:<DEL>:610:29365.19","<DEL>","chr1",139066448,610,"Macaque",1,139067058
"chr3:2575609:<DEL>:927:61950.45","<DEL>","chr3",2575609,927,"Macaque",1,2576536
"chr7:95532305:<DEL>:2165:21418.25","<DEL>","chr7",95532305,2165,"Macaque",1,95534470
"chr7:159856394:<DEL>:809:18670.8","<DEL>","chr7",159856394,809,"Macaque",1,159857203
"chr4:169482652:<DEL>:1049:22245.48","<DEL>","chr4",169482652,1049,"Macaque",1,169483701
"chr12:576974:<DEL>:808:15540.62","<DEL>","chr12",576974,808,"Macaque",1,577782
"chr10:84657892:<DUP>:61811:11481.61","<DUP>","chr10",84657892,61811,"Macaque",1,84719703
"chr1:144094586:<DEL>:461:55742.11","<DEL>","chr1",144094586,461,"Macaque",1,144095047
"chr7:58023968:<DEL>:834:7635.28","<DEL>","chr7",58023968,834,"Macaque",1,58024802
"chr5:137049831:<DEL>:890:20628.79","<DEL>","chr5",137049831,890,"Macaque",1,137050721
"chr1:221837705:<DEL>:932:27824.04","<DEL>","chr1",221837705,932,"Macaque",1,221838637
"chr11:132921568:<DEL>:3033:24634.17","<DEL>","chr11",132921568,3033,"Macaque",1,132924601
"chr4:169971451:<DEL>:708:10933.93","<DEL>","chr4",169971451,708,"Macaque",1,169972159
"chr4:110428138:<DEL>:342:23118.34","<DEL>","chr4",110428138,342,"Macaque",1,110428480
"chr13:30329394:<DEL>:682:14500.43","<DEL>","chr13",30329394,682,"Macaque",1,30330076
"chr9:129757737:<DEL>:675:13730.23","<DEL>","chr9",129757737,675,"Macaque",1,129758412
"chr12:10223523:<DEL>:1508:20231.05","<DEL>","chr12",10223523,1508,"Macaque",1,10225031
"chr16:75291598:<DEL>:705:34580.2","<DEL>","chr16",75291598,705,"Macaque",1,75292303
"chr19:4054347:<DEL>:396:46818.95","<DEL>","chr19",4054347,396,"Macaque",1,4054743
"chr2:102761800:<DEL>:675:35192.51","<DEL>","chr2",102761800,675,"Macaque",1,102762475
"chr14:102272525:<DEL>:52724:21376.97","<DEL>","chr14",102272525,52724,"Macaque",1,102325249
"chr13:91793444:<DEL>:23010:23582.98","<DEL>","chr13",91793444,23010,"Macaque",1,91816454
"chr14:8768679:<DEL>:467:66813.86","<DEL>","chr14",8768679,467,"Macaque",1,8769146
"chr9:128102635:<DUP>:759:25008.9","<DUP>","chr9",128102635,759,"Macaque",1,128103394
"chr13:3096021:<DEL>:1347:15746.17","<DEL>","chr13",3096021,1347,"Macaque",1,3097368
"chr5:123101937:<DEL>:42936:21152.36","<DEL>","chr5",123101937,42936,"Macaque",1,123144873
"chr5:138046603:<DEL>:1003:15369.51","<DEL>","chr5",138046603,1003,"Macaque",1,138047606
"chrX:12523341:<DEL>:735:39649.77","<DEL>","chrX",12523341,735,"Macaque",1,12524076
"chr8:16679689:<DEL>:5186:31258.65","<DEL>","chr8",16679689,5186,"Macaque",1,16684875
"chr19:15678369:<DEL>:9590:11239.03","<DEL>","chr19",15678369,9590,"Macaque",1,15687959
"chr17:89432141:<DEL>:726:56654.43","<DEL>","chr17",89432141,726,"Macaque",1,89432867
"chr16:76633023:<DEL>:2059:67711.42","<DEL>","chr16",76633023,2059,"Macaque",1,76635082
"chr19:7884379:<DEL>:1146:71935.81","<DEL>","chr19",7884379,1146,"Macaque",1,7885525
"chr10:30152034:<DEL>:923:51167.45","<DEL>","chr10",30152034,923,"Macaque",1,30152957
"chr4:140233983:<DEL>:713:11763.86","<DEL>","chr4",140233983,713,"Macaque",1,140234696
"chr7:122054093:<DEL>:5179:57282.77","<DEL>","chr7",122054093,5179,"Macaque",1,122059272
"chr17:51872871:<DEL>:42973:7444.5","<DEL>","chr17",51872871,42973,"Macaque",1,51915844
"chr9:82608960:<DEL>:969:50035.21","<DEL>","chr9",82608960,969,"Macaque",1,82609929
"chr15:39980177:<DEL>:578:14706.77","<DEL>","chr15",39980177,578,"Macaque",1,39980755
"chr10:16807675:<DEL>:1203:52910.3","<DEL>","chr10",16807675,1203,"Macaque",1,16808878
"chr6:51043284:<DEL>:1167:30961.81","<DEL>","chr6",51043284,1167,"Macaque",1,51044451
"chr20:5396205:<DEL>:474:55435.39","<DEL>","chr20",5396205,474,"Macaque",1,5396679
"chrX:13873151:<DEL>:966:7671.33","<DEL>","chrX",13873151,966,"Macaque",1,13874117
"chr15:70103339:<DEL>:655:27001.77","<DEL>","chr15",70103339,655,"Macaque",1,70103994
"chr5:3970994:<DEL>:648:39204.34","<DEL>","chr5",3970994,648,"Macaque",1,3971642
"chr8:78503803:<DEL>:473:35471.04","<DEL>","chr8",78503803,473,"Macaque",1,78504276
"chr3:93284814:<DEL>:974:19138.78","<DEL>","chr3",93284814,974,"Macaque",1,93285788
"chr16:57049407:<DEL>:671:59764.35","<DEL>","chr16",57049407,671,"Macaque",1,57050078
"chr9:113948089:<DEL>:363:72103.48","<DEL>","chr9",113948089,363,"Macaque",1,113948452
"chr13:20049735:<DEL>:2100:25229.26","<DEL>","chr13",20049735,2100,"Macaque",1,20051835
"chr10:65264777:<DEL>:4193:43456.9","<DEL>","chr10",65264777,4193,"Macaque",1,65268970
"chr1:26432647:<DEL>:1065:30221.92","<DEL>","chr1",26432647,1065,"Macaque",1,26433712
"chr8:32219331:<DEL>:2016:16829.03","<DEL>","chr8",32219331,2016,"Macaque",1,32221347
"chr5:164199007:<DEL>:479:13071.06","<DEL>","chr5",164199007,479,"Macaque",1,164199486
"chr6:76225978:<DEL>:522:57617.31","<DEL>","chr6",76225978,522,"Macaque",1,76226500
"chr5:68922463:<DEL>:6191:26655.63","<DEL>","chr5",68922463,6191,"Macaque",1,68928654
"chr16:44028618:<DEL>:583:62883.62","<DEL>","chr16",44028618,583,"Macaque",1,44029201
"chr19:10851692:<DEL>:617:27997.62","<DEL>","chr19",10851692,617,"Macaque",1,10852309
"chr15:11104421:<DEL>:7373:38089.1","<DEL>","chr15",11104421,7373,"Macaque",1,11111794
"chr12:37864279:<DEL>:920:9695.34","<DEL>","chr12",37864279,920,"Macaque",1,37865199
"chr9:2520076:<DEL>:643:9741.23","<DEL>","chr9",2520076,643,"Macaque",1,2520719
"chr20:49831472:<DUP>:469:9591.26","<DUP>","chr20",49831472,469,"Macaque",1,49831941
"chr12:24815364:<DEL>:1699:28442.93","<DEL>","chr12",24815364,1699,"Macaque",1,24817063
"chr11:132036530:<DEL>:2885:128893.6","<DEL>","chr11",132036530,2885,"Macaque",1,132039415
"chr10:69330300:<DEL>:448:67669.92","<DEL>","chr10",69330300,448,"Macaque",1,69330748
"chr16:50058520:<DEL>:600:45347.61","<DEL>","chr16",50058520,600,"Macaque",1,50059120
"chr19:45906049:<DEL>:2204:15599.23","<DEL>","chr19",45906049,2204,"Macaque",1,45908253
"chr8:8037741:<DEL>:585:38069.29","<DEL>","chr8",8037741,585,"Macaque",1,8038326
"chr4:29579673:<DEL>:80190:14155.38","<DEL>","chr4",29579673,80190,"Macaque",1,29659863
"chr14:8107920:<DEL>:416:37928.67","<DEL>","chr14",8107920,416,"Macaque",1,8108336
"chr6:235725:<DEL>:5694:27855.5","<DEL>","chr6",235725,5694,"Macaque",1,241419
"chr10:92157987:<DEL>:1952:13652.06","<DEL>","chr10",92157987,1952,"Macaque",1,92159939
"chr7:104079025:<DEL>:3190:40148.14","<DEL>","chr7",104079025,3190,"Macaque",1,104082215
"chr3:73963799:<DEL>:425:19026.27","<DEL>","chr3",73963799,425,"Macaque",1,73964224
"chr5:140300053:<DEL>:48404:46411.15","<DEL>","chr5",140300053,48404,"Macaque",1,140348457
"chr5:8302426:<DEL>:3580:21743.26","<DEL>","chr5",8302426,3580,"Macaque",1,8306006
"chr15:40923603:<DEL>:498:24488.37","<DEL>","chr15",40923603,498,"Macaque",1,40924101
"chr9:89791655:<DEL>:1310:10162.17","<DEL>","chr9",89791655,1310,"Macaque",1,89792965
"chr12:114847169:<DUP>:58364:8158.62","<DUP>","chr12",114847169,58364,"Macaque",1,114905533
"chr19:16192649:<DEL>:77410:20864.37","<DEL>","chr19",16192649,77410,"Macaque",1,16270059
"chr12:53562899:<DEL>:635:39893.1","<DEL>","chr12",53562899,635,"Macaque",1,53563534
"chr5:7967613:<DEL>:447:12639.14","<DEL>","chr5",7967613,447,"Macaque",1,7968060
"chr9:109275350:<DEL>:2382:38080.17","<DEL>","chr9",109275350,2382,"Macaque",1,109277732
"chr4:73964907:<DEL>:838:27921.91","<DEL>","chr4",73964907,838,"Macaque",1,73965745
"chr11:125652570:<DEL>:641:19088.78","<DEL>","chr11",125652570,641,"Macaque",1,125653211
"chr5:3969736:<DEL>:647:13956.05","<DEL>","chr5",3969736,647,"Macaque",1,3970383
"chr9:128909771:<DUP>:571:14567.66","<DUP>","chr9",128909771,571,"Macaque",1,128910342
"chr15:90499043:<DEL>:1941:17208.65","<DEL>","chr15",90499043,1941,"Macaque",1,90500984
"chrX:19891028:<DEL>:6342:20620.67","<DEL>","chrX",19891028,6342,"Macaque",1,19897370
"chr2:129155798:<DEL>:645:28133.12","<DEL>","chr2",129155798,645,"Macaque",1,129156443
"chr8:108508147:<DEL>:559:27944.49","<DEL>","chr8",108508147,559,"Macaque",1,108508706
"chr7:4813541:<DEL>:978:18470.4","<DEL>","chr7",4813541,978,"Macaque",1,4814519
"chr7:62069831:<DEL>:1380:30710.13","<DEL>","chr7",62069831,1380,"Macaque",1,62071211
"chr10:30458650:<DUP>:533:9032.27","<DUP>","chr10",30458650,533,"Macaque",1,30459183
"chr9:83692423:<DUP>:410:9150.4","<DUP>","chr9",83692423,410,"Macaque",1,83692833
"chr11:132049722:<DEL>:30003:10136.67","<DEL>","chr11",132049722,30003,"Macaque",1,132079725
"chr3:70474952:<DEL>:389:9587.17","<DEL>","chr3",70474952,389,"Macaque",1,70475341
"chr7:90351966:<DEL>:1327:33276.89","<DEL>","chr7",90351966,1327,"Macaque",1,90353293
"chr2:10465979:<DEL>:57067:19905.04","<DEL>","chr2",10465979,57067,"Macaque",1,10523046
"chr14:95645087:<DUP>:537:13164.2","<DUP>","chr14",95645087,537,"Macaque",1,95645624
"chr5:32046576:<DEL>:9043:27960.03","<DEL>","chr5",32046576,9043,"Macaque",1,32055619
"chr9:129398093:<DEL>:519:38752.1","<DEL>","chr9",129398093,519,"Macaque",1,129398612
"chr8:85960119:<DEL>:592:31565.03","<DEL>","chr8",85960119,592,"Macaque",1,85960711
"chr3:19790993:<DEL>:1878:32013.78","<DEL>","chr3",19790993,1878,"Macaque",1,19792871
"chr4:24791477:<DEL>:989:22733.71","<DEL>","chr4",24791477,989,"Macaque",1,24792466
"chr17:55053466:<DEL>:1553:17221.78","<DEL>","chr17",55053466,1553,"Macaque",1,55055019
"chr7:11319502:<DEL>:441:14566.84","<DEL>","chr7",11319502,441,"Macaque",1,11319943
"chr16:74141961:<DEL>:1271:8306.4","<DEL>","chr16",74141961,1271,"Macaque",1,74143232
"chrX:19904616:<DEL>:764:27777.3","<DEL>","chrX",19904616,764,"Macaque",1,19905380
"chr16:49748116:<DEL>:1113:54446.69","<DEL>","chr16",49748116,1113,"Macaque",1,49749229
"chrX:112079777:<DEL>:879:27355.3","<DEL>","chrX",112079777,879,"Macaque",1,112080656
"chr3:184692915:<DEL>:800:14588.32","<DEL>","chr3",184692915,800,"Macaque",1,184693715
"chr15:14136232:<DUP>:900:119275.76","<DUP>","chr15",14136232,900,"Macaque",1,14137132
"chr14:78578590:<DEL>:672:15197.87","<DEL>","chr14",78578590,672,"Macaque",1,78579262
"chr5:66734627:<DEL>:899:21776.35","<DEL>","chr5",66734627,899,"Macaque",1,66735526
"chr1:22125:<DEL>:632:67799.39","<DEL>","chr1",22125,632,"Macaque",1,22757
"chr20:72906888:<DEL>:3365:14622.24","<DEL>","chr20",72906888,3365,"Macaque",1,72910253
"chr14:54904517:<DEL>:3506:19527.59","<DEL>","chr14",54904517,3506,"Macaque",1,54908023
"chr15:11105041:<DEL>:6752:31994.45","<DEL>","chr15",11105041,6752,"Macaque",1,11111793
"chr6:149247615:<DEL>:988:37333.77","<DEL>","chr6",149247615,988,"Macaque",1,149248603
"chr6:128416162:<DEL>:1753:28738.34","<DEL>","chr6",128416162,1753,"Macaque",1,128417915
"chr3:130690864:<DEL>:1251:34497.6","<DEL>","chr3",130690864,1251,"Macaque",1,130692115
"chr12:2117893:<DEL>:708:31258.43","<DEL>","chr12",2117893,708,"Macaque",1,2118601
"chr8:21984567:<DEL>:619:31652.99","<DEL>","chr8",21984567,619,"Macaque",1,21985186
"chr8:2021670:<DEL>:2457:60621.07","<DEL>","chr8",2021670,2457,"Macaque",1,2024127
"chr3:88782414:<DEL>:1011:15705.87","<DEL>","chr3",88782414,1011,"Macaque",1,88783425
"chr15:90529010:<DEL>:1945:24224.8","<DEL>","chr15",90529010,1945,"Macaque",1,90530955
"chr7:136364669:<DEL>:734:9190.92","<DEL>","chr7",136364669,734,"Macaque",1,136365403
"chr2:121571625:<DEL>:696:7026.28","<DEL>","chr2",121571625,696,"Macaque",1,121572321
"chr9:1374108:<DEL>:904:40906.24","<DEL>","chr9",1374108,904,"Macaque",1,1375012
"chr3:73318051:<DEL>:2079:34062.43","<DEL>","chr3",73318051,2079,"Macaque",1,73320130
"chr6:72741369:<DEL>:1587:32815.49","<DEL>","chr6",72741369,1587,"Macaque",1,72742956
"chr1:90539047:<DEL>:2833:13895.59","<DEL>","chr1",90539047,2833,"Macaque",1,90541880
"chr20:52834283:<DEL>:633:60394.27","<DEL>","chr20",52834283,633,"Macaque",1,52834916
"chr8:129717226:<DEL>:35821:16809.6","<DEL>","chr8",129717226,35821,"Macaque",1,129753047
"chr13:94136026:<DEL>:2331:12703.69","<DEL>","chr13",94136026,2331,"Macaque",1,94138357
"chr10:2786111:<DEL>:906:51817.4","<DEL>","chr10",2786111,906,"Macaque",1,2787017
"chr16:516539:<DEL>:1298:5911.16","<DEL>","chr16",516539,1298,"Macaque",1,517837
"chr9:46031281:<DEL>:2430:20526.3","<DEL>","chr9",46031281,2430,"Macaque",1,46033711
"chr9:118626939:<DUP>:3056:17808.17","<DUP>","chr9",118626939,3056,"Macaque",1,118629995
"chr15:44064838:<DEL>:582:31693.33","<DEL>","chr15",44064838,582,"Macaque",1,44065420
"chr3:5590386:<DEL>:683:9019.04","<DEL>","chr3",5590386,683,"Macaque",1,5591069
"chr5:4376815:<DUP>:495:15261.2","<DUP>","chr5",4376815,495,"Macaque",1,4377310
"chr1:94985468:<DEL>:646:32111.06","<DEL>","chr1",94985468,646,"Macaque",1,94986114
"chr8:19662568:<DEL>:1125:50724.36","<DEL>","chr8",19662568,1125,"Macaque",1,19663693
"chr13:3063343:<DEL>:874:32614.84","<DEL>","chr13",3063343,874,"Macaque",1,3064217
"chr6:28634452:<DEL>:895:25525.34","<DEL>","chr6",28634452,895,"Macaque",1,28635347
"chr7:166009857:<DEL>:3818:38198.36","<DEL>","chr7",166009857,3818,"Macaque",1,166013675
"chr6:39198725:<DEL>:2650:7567.65","<DEL>","chr6",39198725,2650,"Macaque",1,39201375
"chr6:32687342:<DEL>:318:46330.92","<DEL>","chr6",32687342,318,"Macaque",1,32687660
"chr6:47746536:<DEL>:825:24797.76","<DEL>","chr6",47746536,825,"Macaque",1,47747361
"chr14:2980725:<DEL>:1524:42097.93","<DEL>","chr14",2980725,1524,"Macaque",1,2982249
"chr1:223749878:<DEL>:661:46427.59","<DEL>","chr1",223749878,661,"Macaque",1,223750539
"chr14:89568806:<DEL>:1523:10485.6","<DEL>","chr14",89568806,1523,"Macaque",1,89570329
"chr18:2425354:<DEL>:772:67563.52","<DEL>","chr18",2425354,772,"Macaque",1,2426126
"chr3:10904401:<DEL>:991:23545.33","<DEL>","chr3",10904401,991,"Macaque",1,10905392
"chr16:2190785:<DEL>:40602:44256.72","<DEL>","chr16",2190785,40602,"Macaque",1,2231387
"chr16:68052105:<DEL>:3841:24220.0","<DEL>","chr16",68052105,3841,"Macaque",1,68055946
"chr2:53380148:<DEL>:829:27869.94","<DEL>","chr2",53380148,829,"Macaque",1,53380977
"chr11:6906475:<DEL>:58235:51167.5","<DEL>","chr11",6906475,58235,"Macaque",1,6964710
"chr5:59520206:<DEL>:48643:27681.25","<DEL>","chr5",59520206,48643,"Macaque",1,59568849
"chr14:583488:<DEL>:838:7785.3","<DEL>","chr14",583488,838,"Macaque",1,584326
"chr4:169105614:<DEL>:576:52067.8","<DEL>","chr4",169105614,576,"Macaque",1,169106190
"chr4:71674039:<DEL>:581:10520.66","<DEL>","chr4",71674039,581,"Macaque",1,71674620
"chr13:94160947:<DEL>:632:28831.53","<DEL>","chr13",94160947,632,"Macaque",1,94161579
"chr2:23447052:<DEL>:3789:49780.31","<DEL>","chr2",23447052,3789,"Macaque",1,23450841
"chr19:3274534:<DEL>:5661:25595.08","<DEL>","chr19",3274534,5661,"Macaque",1,3280195
"chr15:84471986:<DEL>:676:12496.13","<DEL>","chr15",84471986,676,"Macaque",1,84472662
"chr4:144113464:<DEL>:1299:15569.06","<DEL>","chr4",144113464,1299,"Macaque",1,144114763
"chr8:138956650:<DEL>:2762:25986.49","<DEL>","chr8",138956650,2762,"Macaque",1,138959412
"chr9:61787250:<DEL>:1461:26942.7","<DEL>","chr9",61787250,1461,"Macaque",1,61788711
"chr20:72578050:<DEL>:1090:29542.44","<DEL>","chr20",72578050,1090,"Macaque",1,72579140
"chr19:17612125:<DEL>:891:44934.03","<DEL>","chr19",17612125,891,"Macaque",1,17613016
"chr13:75344418:<DEL>:407:9489.89","<DEL>","chr13",75344418,407,"Macaque",1,75344825
"chr2:189928217:<DEL>:349:30995.51","<DEL>","chr2",189928217,349,"Macaque",1,189928566
"chr15:82637075:<DEL>:560:11230.54","<DEL>","chr15",82637075,560,"Macaque",1,82637635
"chr13:2846434:<DEL>:1873:47888.25","<DEL>","chr13",2846434,1873,"Macaque",1,2848307
"chr7:47860294:<DEL>:1805:28006.24","<DEL>","chr7",47860294,1805,"Macaque",1,47862099
"chr1:220759710:<DEL>:1150:38507.97","<DEL>","chr1",220759710,1150,"Macaque",1,220760860
"chr1:154637758:<DEL>:838:46499.79","<DEL>","chr1",154637758,838,"Macaque",1,154638596
"chr20:34633564:<DUP>:489:8708.74","<DUP>","chr20",34633564,489,"Macaque",1,34634053
"chr4:8690899:<DEL>:2064:19941.15","<DEL>","chr4",8690899,2064,"Macaque",1,8692963
"chr3:125766468:<DUP>:17068:13560.98","<DUP>","chr3",125766468,17068,"Macaque",1,125783536
"chr19:48423523:<DEL>:757:65643.28","<DEL>","chr19",48423523,757,"Macaque",1,48424280
"chr20:809802:<DEL>:1067:30238.44","<DEL>","chr20",809802,1067,"Macaque",1,810869
"chr19:1942884:<DEL>:1788:13247.53","<DEL>","chr19",1942884,1788,"Macaque",1,1944672
"chr11:121815159:<DEL>:4243:50901.62","<DEL>","chr11",121815159,4243,"Macaque",1,121819402
"chr1:4065925:<DUP>:181:26957.98","<DUP>","chr1",4065925,181,"Macaque",1,4066106
"chr12:125065568:<DEL>:36961:9929.71","<DEL>","chr12",125065568,36961,"Macaque",1,125102529
"chr4:169897470:<DEL>:9228:16541.37","<DEL>","chr4",169897470,9228,"Macaque",1,169906698
"chr8:46083162:<DEL>:551:58759.45","<DEL>","chr8",46083162,551,"Macaque",1,46083713
"chr7:30647842:<DEL>:440:26007.59","<DEL>","chr7",30647842,440,"Macaque",1,30648282
"chr9:31198671:<DEL>:391:46882.48","<DEL>","chr9",31198671,391,"Macaque",1,31199062
"chr19:1031843:<DEL>:1549:63132.15","<DEL>","chr19",1031843,1549,"Macaque",1,1033392
"chr5:26690141:<DEL>:1505:42866.06","<DEL>","chr5",26690141,1505,"Macaque",1,26691646
"chr18:1051321:<DUP>:638:40988.31","<DUP>","chr18",1051321,638,"Macaque",1,1051959
"chr17:75111002:<DEL>:876:16429.54","<DEL>","chr17",75111002,876,"Macaque",1,75111878
"chr3:118024483:<DEL>:716:25229.25","<DEL>","chr3",118024483,716,"Macaque",1,118025199
"chr1:185807569:<DEL>:487:22352.11","<DEL>","chr1",185807569,487,"Macaque",1,185808056
"chr4:102008030:<DEL>:453:20302.59","<DEL>","chr4",102008030,453,"Macaque",1,102008483
"chr2:202599760:<DEL>:951:46308.25","<DEL>","chr2",202599760,951,"Macaque",1,202600711
"chr11:120437001:<DEL>:330:31224.22","<DEL>","chr11",120437001,330,"Macaque",1,120437331
"chr7:54890323:<DEL>:648:27112.53","<DEL>","chr7",54890323,648,"Macaque",1,54890971
"chr10:62768400:<DEL>:4092:66322.74","<DEL>","chr10",62768400,4092,"Macaque",1,62772492
"chr11:45228534:<DEL>:501:52557.08","<DEL>","chr11",45228534,501,"Macaque",1,45229035
"chr7:168590207:<DUP>:10612:14149.43","<DUP>","chr7",168590207,10612,"Macaque",1,168600819
"chr20:52200802:<DEL>:2290:19160.85","<DEL>","chr20",52200802,2290,"Macaque",1,52203092
"chr13:5447874:<DUP>:154:54511.26","<DUP>","chr13",5447874,154,"Macaque",1,5448028
"chr12:108782785:<DEL>:923:57519.13","<DEL>","chr12",108782785,923,"Macaque",1,108783708
"chr11:90268576:<DEL>:34820:29173.42","<DEL>","chr11",90268576,34820,"Macaque",1,90303396
"chr17:93405481:<DEL>:386:22906.04","<DEL>","chr17",93405481,386,"Macaque",1,93405867
"chrX:96278:<DEL>:940:31957.16","<DEL>","chrX",96278,940,"Macaque",1,97218
"chr18:66999127:<DEL>:1732:8643.36","<DEL>","chr18",66999127,1732,"Macaque",1,67000859
"chr10:17333348:<DEL>:955:39527.05","<DEL>","chr10",17333348,955,"Macaque",1,17334303
"chr7:27109361:<DEL>:2367:35096.4","<DEL>","chr7",27109361,2367,"Macaque",1,27111728
"chr8:38083847:<DEL>:342:28762.81","<DEL>","chr8",38083847,342,"Macaque",1,38084189
"chr5:109101395:<DEL>:53510:59439.35","<DEL>","chr5",109101395,53510,"Macaque",1,109154905
"chr15:2336583:<DEL>:1498:52930.0","<DEL>","chr15",2336583,1498,"Macaque",1,2338081
"chr16:6028432:<DEL>:818:6180.78","<DEL>","chr16",6028432,818,"Macaque",1,6029250
"chr12:122326265:<DEL>:6745:31846.74","<DEL>","chr12",122326265,6745,"Macaque",1,122333010
"chr9:93362000:<DEL>:11596:30880.16","<DEL>","chr9",93362000,11596,"Macaque",1,93373596
"chr3:63826065:<DEL>:1181:11995.22","<DEL>","chr3",63826065,1181,"Macaque",1,63827246
"chr15:2577222:<DEL>:1980:40655.94","<DEL>","chr15",2577222,1980,"Macaque",1,2579202
"chr5:68816057:<DEL>:34025:27403.18","<DEL>","chr5",68816057,34025,"Macaque",1,68850082
"chr7:62069526:<DEL>:1686:20816.61","<DEL>","chr7",62069526,1686,"Macaque",1,62071212
"chr14:65299443:<DEL>:516:11871.23","<DEL>","chr14",65299443,516,"Macaque",1,65299959
"chr8:50963260:<DEL>:1037:41551.26","<DEL>","chr8",50963260,1037,"Macaque",1,50964297
"chr3:182687571:<DUP>:393:10303.12","<DUP>","chr3",182687571,393,"Macaque",1,182687964
"chr5:7431054:<DEL>:616:8361.46","<DEL>","chr5",7431054,616,"Macaque",1,7431670
"chr1:42870630:<DEL>:817:53412.71","<DEL>","chr1",42870630,817,"Macaque",1,42871447
"chr3:33880088:<DEL>:1001:7167.02","<DEL>","chr3",33880088,1001,"Macaque",1,33881089
"chr16:34195975:<DEL>:759:39764.1","<DEL>","chr16",34195975,759,"Macaque",1,34196734
"chr6:140986769:<DEL>:545:19254.54","<DEL>","chr6",140986769,545,"Macaque",1,140987314
"chr8:104084298:<DEL>:2585:32053.53","<DEL>","chr8",104084298,2585,"Macaque",1,104086883
"chr3:182578563:<DEL>:432:16756.71","<DEL>","chr3",182578563,432,"Macaque",1,182578995
"chr4:170382116:<DEL>:543:25823.97","<DEL>","chr4",170382116,543,"Macaque",1,170382659
"chr10:90736559:<DEL>:1262:31610.49","<DEL>","chr10",90736559,1262,"Macaque",1,90737821
"chrX:121690105:<DUP>:1100:6859.82","<DUP>","chrX",121690105,1100,"Macaque",1,121691205
"chr16:66825210:<DEL>:807:50872.08","<DEL>","chr16",66825210,807,"Macaque",1,66826017
"chr10:89777377:<DEL>:12126:45524.83","<DEL>","chr10",89777377,12126,"Macaque",1,89789503
"chr15:67261733:<DEL>:1185:21245.78","<DEL>","chr15",67261733,1185,"Macaque",1,67262918
"chr15:103707432:<DEL>:993:11299.87","<DEL>","chr15",103707432,993,"Macaque",1,103708425
"chr11:117893993:<DUP>:576:10543.6","<DUP>","chr11",117893993,576,"Macaque",1,117894569
"chr19:8085872:<DEL>:676:73235.23","<DEL>","chr19",8085872,676,"Macaque",1,8086548
"chr5:792834:<DEL>:780:16130.21","<DEL>","chr5",792834,780,"Macaque",1,793614
"chr4:111600077:<DEL>:640:37674.62","<DEL>","chr4",111600077,640,"Macaque",1,111600717
"chr1:1688672:<DEL>:995:12706.79","<DEL>","chr1",1688672,995,"Macaque",1,1689667
"chr7:114698785:<DEL>:407:19143.44","<DEL>","chr7",114698785,407,"Macaque",1,114699192
"chr8:140951348:<DEL>:633:4483.55","<DEL>","chr8",140951348,633,"Macaque",1,140951981
"chr16:38802089:<DEL>:699:13637.0","<DEL>","chr16",38802089,699,"Macaque",1,38802788
"chr3:127788161:<DEL>:3791:11846.85","<DEL>","chr3",127788161,3791,"Macaque",1,127791952
"chr5:93225936:<DEL>:834:13019.05","<DEL>","chr5",93225936,834,"Macaque",1,93226770
"chr16:8135913:<DEL>:822:47947.34","<DEL>","chr16",8135913,822,"Macaque",1,8136735
"chr8:5037799:<DEL>:848:19324.46","<DEL>","chr8",5037799,848,"Macaque",1,5038647
"chr5:105954209:<DEL>:433:17860.85","<DEL>","chr5",105954209,433,"Macaque",1,105954642
"chr5:89532953:<DEL>:656:50674.37","<DEL>","chr5",89532953,656,"Macaque",1,89533609
"chr20:131782:<DUP>:3574:9496.51","<DUP>","chr20",131782,3574,"Macaque",1,135356
"chrX:56749210:<DEL>:13863:24646.81","<DEL>","chrX",56749210,13863,"Macaque",1,56763073
"chr13:48663519:<DEL>:3045:25018.73","<DEL>","chr13",48663519,3045,"Macaque",1,48666564
"chr12:155756:<DUP>:511:13048.92","<DUP>","chr12",155756,511,"Macaque",1,156267
"chr15:2189794:<DEL>:1921:13712.9","<DEL>","chr15",2189794,1921,"Macaque",1,2191715
"chr20:12520789:<DEL>:1115:35794.73","<DEL>","chr20",12520789,1115,"Macaque",1,12521904
"chr5:83971248:<DEL>:722:43161.48","<DEL>","chr5",83971248,722,"Macaque",1,83971970
"chr1:1116785:<DEL>:5210:34416.92","<DEL>","chr1",1116785,5210,"Macaque",1,1121995
"chr16:66467631:<DEL>:448:44925.59","<DEL>","chr16",66467631,448,"Macaque",1,66468079
"chr8:131705295:<DEL>:1834:19143.51","<DEL>","chr8",131705295,1834,"Macaque",1,131707129
"chr14:81586642:<DEL>:470:26629.36","<DEL>","chr14",81586642,470,"Macaque",1,81587112
"chr11:16204207:<DEL>:928:23379.93","<DEL>","chr11",16204207,928,"Macaque",1,16205135
"chr6:57696041:<DEL>:1002:13894.97","<DEL>","chr6",57696041,1002,"Macaque",1,57697043
"chr11:32195430:<DEL>:13473:6945.42","<DEL>","chr11",32195430,13473,"Macaque",1,32208903
"chr8:21952520:<DEL>:468:28149.62","<DEL>","chr8",21952520,468,"Macaque",1,21952988
"chr4:162974120:<DEL>:2812:49956.26","<DEL>","chr4",162974120,2812,"Macaque",1,162976932
"chr6:48979883:<DEL>:764:21583.1","<DEL>","chr6",48979883,764,"Macaque",1,48980647
"chr13:43872124:<DEL>:777:50310.75","<DEL>","chr13",43872124,777,"Macaque",1,43872901
"chr17:94836673:<DUP>:1307:8863.26","<DUP>","chr17",94836673,1307,"Macaque",1,94837980
"chr10:92732697:<DEL>:1040:72910.71","<DEL>","chr10",92732697,1040,"Macaque",1,92733737
"chr7:55805689:<DEL>:638:36254.55","<DEL>","chr7",55805689,638,"Macaque",1,55806327
"chr6:106641429:<DEL>:370:19244.34","<DEL>","chr6",106641429,370,"Macaque",1,106641799
"chr15:65634531:<DEL>:465:26568.64","<DEL>","chr15",65634531,465,"Macaque",1,65634996
"chr17:92286070:<DEL>:688:13948.59","<DEL>","chr17",92286070,688,"Macaque",1,92286758
"chr13:17983566:<DEL>:1394:19422.87","<DEL>","chr13",17983566,1394,"Macaque",1,17984960
"chr6:72965466:<DEL>:8243:5873.41","<DEL>","chr6",72965466,8243,"Macaque",1,72973709
"chr19:35645919:<DUP>:15752:19282.13","<DUP>","chr19",35645919,15752,"Macaque",1,35661671
"chr19:28174771:<DEL>:618:12027.94","<DEL>","chr19",28174771,618,"Macaque",1,28175389
"chr20:2144218:<DEL>:565:78119.73","<DEL>","chr20",2144218,565,"Macaque",1,2144783
"chr1:182781213:<DEL>:6889:22477.11","<DEL>","chr1",182781213,6889,"Macaque",1,182788102
"chr9:89632752:<DEL>:1083:19167.58","<DEL>","chr9",89632752,1083,"Macaque",1,89633835
"chr9:118602277:<DEL>:26929:45921.61","<DEL>","chr9",118602277,26929,"Macaque",1,118629206
"chr13:3060170:<DEL>:3469:45323.9","<DEL>","chr13",3060170,3469,"Macaque",1,3063639
"chr20:34634007:<DEL>:552:20691.78","<DEL>","chr20",34634007,552,"Macaque",1,34634559
"chr10:66426176:<DEL>:456:48389.48","<DEL>","chr10",66426176,456,"Macaque",1,66426632
"chr11:132680275:<DEL>:945:26621.91","<DEL>","chr11",132680275,945,"Macaque",1,132681220
"chr20:2214831:<DEL>:908:37637.04","<DEL>","chr20",2214831,908,"Macaque",1,2215739
"chr3:176016913:<DEL>:1235:60798.29","<DEL>","chr3",176016913,1235,"Macaque",1,176018148
"chr19:29080418:<DEL>:1144:66588.6","<DEL>","chr19",29080418,1144,"Macaque",1,29081562
"chr9:129549683:<DEL>:26676:43900.04","<DEL>","chr9",129549683,26676,"Macaque",1,129576359
"chr11:59476968:<DEL>:3910:46233.88","<DEL>","chr11",59476968,3910,"Macaque",1,59480878
"chr7:168551774:<DEL>:3715:14618.54","<DEL>","chr7",168551774,3715,"Macaque",1,168555489
"chr11:132917082:<DEL>:1799:11679.69","<DEL>","chr11",132917082,1799,"Macaque",1,132918881
"chr11:132342616:<DEL>:813:41004.9","<DEL>","chr11",132342616,813,"Macaque",1,132343429
"chr3:92944352:<DEL>:2413:20155.52","<DEL>","chr3",92944352,2413,"Macaque",1,92946765
"chr15:639322:<DEL>:2054:38130.73","<DEL>","chr15",639322,2054,"Macaque",1,641376
"chr15:4768617:<DEL>:2054:46677.02","<DEL>","chr15",4768617,2054,"Macaque",1,4770671
"chr16:48299618:<DEL>:958:61359.62","<DEL>","chr16",48299618,958,"Macaque",1,48300576
"chr7:27052314:<DEL>:704:16626.06","<DEL>","chr7",27052314,704,"Macaque",1,27053018
"chr17:71060954:<DEL>:69136:31780.13","<DEL>","chr17",71060954,69136,"Macaque",1,71130090
"chr3:26822531:<DEL>:903:21323.55","<DEL>","chr3",26822531,903,"Macaque",1,26823434
"chr16:6980785:<DEL>:688:27405.68","<DEL>","chr16",6980785,688,"Macaque",1,6981473
"chr5:143955516:<DUP>:799:18275.66","<DUP>","chr5",143955516,799,"Macaque",1,143956315
"chr4:19385925:<DEL>:1838:13946.88","<DEL>","chr4",19385925,1838,"Macaque",1,19387763
"chr7:52100535:<DEL>:2634:42189.26","<DEL>","chr7",52100535,2634,"Macaque",1,52103169
"chr14:870548:<DUP>:617:24076.69","<DUP>","chr14",870548,617,"Macaque",1,871165
"chrX:86418:<DEL>:1176:8554.77","<DEL>","chrX",86418,1176,"Macaque",1,87594
"chr6:40138363:<DEL>:8067:35428.81","<DEL>","chr6",40138363,8067,"Macaque",1,40146430
"chr11:55910190:<DEL>:722:60946.0","<DEL>","chr11",55910190,722,"Macaque",1,55910912
"chr14:10647941:<DEL>:301:66478.17","<DEL>","chr14",10647941,301,"Macaque",1,10648242
"chr8:22515601:<DEL>:1166:43515.98","<DEL>","chr8",22515601,1166,"Macaque",1,22516767
"chr8:1728081:<DEL>:668:14129.91","<DEL>","chr8",1728081,668,"Macaque",1,1728749
"chr11:93590348:<DEL>:44558:28869.65","<DEL>","chr11",93590348,44558,"Macaque",1,93634906
"chr16:1948481:<DEL>:655:54564.87","<DEL>","chr16",1948481,655,"Macaque",1,1949136
"chr11:62289884:<DEL>:518:17091.1","<DEL>","chr11",62289884,518,"Macaque",1,62290402
"chr15:23949814:<DEL>:1295:13559.15","<DEL>","chr15",23949814,1295,"Macaque",1,23951109
"chr13:44465616:<DEL>:491:13428.02","<DEL>","chr13",44465616,491,"Macaque",1,44466107
"chr5:67705388:<DEL>:328:17224.39","<DEL>","chr5",67705388,328,"Macaque",1,67705716
"chr8:141362672:<DEL>:4146:21395.0","<DEL>","chr8",141362672,4146,"Macaque",1,141366818
"chr20:948001:<DEL>:2218:58612.16","<DEL>","chr20",948001,2218,"Macaque",1,950219
"chr9:129468236:<DEL>:3651:73796.98","<DEL>","chr9",129468236,3651,"Macaque",1,129471887
"chr20:29865248:<DEL>:3118:19083.96","<DEL>","chr20",29865248,3118,"Macaque",1,29868366
"chr5:66077378:<DEL>:352:26723.81","<DEL>","chr5",66077378,352,"Macaque",1,66077730
"chr1:1067825:<DUP>:848:14212.67","<DUP>","chr1",1067825,848,"Macaque",1,1068673
"chr7:141752425:<DEL>:1109:54476.22","<DEL>","chr7",141752425,1109,"Macaque",1,141753534
"chr6:957193:<DEL>:686:34479.23","<DEL>","chr6",957193,686,"Macaque",1,957879
"chr10:86351042:<DEL>:1427:36278.42","<DEL>","chr10",86351042,1427,"Macaque",1,86352469
"chr5:126016564:<DEL>:643:21546.56","<DEL>","chr5",126016564,643,"Macaque",1,126017207
"chr10:7441377:<DEL>:2887:10895.31","<DEL>","chr10",7441377,2887,"Macaque",1,7444264
"chr11:132519658:<DEL>:773:29276.55","<DEL>","chr11",132519658,773,"Macaque",1,132520431
"chr4:65080507:<DEL>:806:43236.99","<DEL>","chr4",65080507,806,"Macaque",1,65081313
"chr3:72269893:<DUP>:655:7115.42","<DUP>","chr3",72269893,655,"Macaque",1,72270548
"chr16:52772476:<DEL>:655:8092.41","<DEL>","chr16",52772476,655,"Macaque",1,52773131
"chr10:27899740:<DEL>:344:55374.46","<DEL>","chr10",27899740,344,"Macaque",1,27900084
"chr1:52958805:<DEL>:565:30792.77","<DEL>","chr1",52958805,565,"Macaque",1,52959370
"chr8:86435551:<DEL>:788:31364.66","<DEL>","chr8",86435551,788,"Macaque",1,86436339
"chr11:51635954:<DEL>:414:35450.92","<DEL>","chr11",51635954,414,"Macaque",1,51636368
"chr20:623036:<DEL>:754:49344.06","<DEL>","chr20",623036,754,"Macaque",1,623790
"chr14:31542915:<DEL>:616:14580.72","<DEL>","chr14",31542915,616,"Macaque",1,31543531
"chr7:162565071:<DEL>:951:10045.23","<DEL>","chr7",162565071,951,"Macaque",1,162566022
"chr1:115670260:<DEL>:1547:60030.2","<DEL>","chr1",115670260,1547,"Macaque",1,115671807
"chr16:56404943:<DEL>:840:52563.29","<DEL>","chr16",56404943,840,"Macaque",1,56405783
"chr19:26661733:<DEL>:1100:7142.93","<DEL>","chr19",26661733,1100,"Macaque",1,26662833
"chr16:51467521:<DEL>:331:30566.71","<DEL>","chr16",51467521,331,"Macaque",1,51467852
"chr4:129372000:<DEL>:313:31621.0","<DEL>","chr4",129372000,313,"Macaque",1,129372313
"chr1:26523974:<DEL>:366:32890.09","<DEL>","chr1",26523974,366,"Macaque",1,26524340
"chr15:88204758:<DEL>:942:56721.45","<DEL>","chr15",88204758,942,"Macaque",1,88205700
"chr15:43748110:<DEL>:1451:70990.49","<DEL>","chr15",43748110,1451,"Macaque",1,43749561
"chr13:1663333:<DEL>:703:36611.99","<DEL>","chr13",1663333,703,"Macaque",1,1664036
"chr11:96305476:<DEL>:968:15668.86","<DEL>","chr11",96305476,968,"Macaque",1,96306444
"chr18:10937369:<DEL>:2195:13045.48","<DEL>","chr18",10937369,2195,"Macaque",1,10939564
"chr8:56873459:<DEL>:446:21602.33","<DEL>","chr8",56873459,446,"Macaque",1,56873905
"chr1:22273149:<DEL>:514:79852.69","<DEL>","chr1",22273149,514,"Macaque",1,22273663
"chr8:141461019:<DUP>:618:27648.62","<DUP>","chr8",141461019,618,"Macaque",1,141461637
"chr11:56003107:<DEL>:383:51869.61","<DEL>","chr11",56003107,383,"Macaque",1,56003490
"chr3:76408718:<DEL>:417:65350.71","<DEL>","chr3",76408718,417,"Macaque",1,76409135
"chr13:101197526:<DEL>:421:18612.66","<DEL>","chr13",101197526,421,"Macaque",1,101197947
"chr5:59520110:<DEL>:43571:59468.92","<DEL>","chr5",59520110,43571,"Macaque",1,59563681
"chr19:34930431:<DEL>:3753:32606.43","<DEL>","chr19",34930431,3753,"Macaque",1,34934184
"chr8:141834244:<DEL>:614:8418.21","<DEL>","chr8",141834244,614,"Macaque",1,141834858
"chr3:35543424:<DEL>:951:53438.46","<DEL>","chr3",35543424,951,"Macaque",1,35544375
"chr2:195576357:<DEL>:915:11214.46","<DEL>","chr2",195576357,915,"Macaque",1,195577272
"chr18:19492347:<DUP>:469:18587.49","<DUP>","chr18",19492347,469,"Macaque",1,19492816
"chr11:98409121:<DEL>:3318:18652.41","<DEL>","chr11",98409121,3318,"Macaque",1,98412439
"chr7:166976776:<DEL>:310:21478.78","<DEL>","chr7",166976776,310,"Macaque",1,166977086
"chr7:162705386:<DEL>:860:18839.2","<DEL>","chr7",162705386,860,"Macaque",1,162706246
"chr4:46878603:<DEL>:420:18328.01","<DEL>","chr4",46878603,420,"Macaque",1,46879023
"chr5:110837027:<DEL>:1189:11204.79","<DEL>","chr5",110837027,1189,"Macaque",1,110838216
"chr10:91250406:<DEL>:3757:36691.94","<DEL>","chr10",91250406,3757,"Macaque",1,91254163
"chr9:104849214:<DEL>:6721:44779.69","<DEL>","chr9",104849214,6721,"Macaque",1,104855935
"chr15:17557973:<DEL>:698:73572.6","<DEL>","chr15",17557973,698,"Macaque",1,17558671
"chr20:4947111:<DEL>:1345:13087.5","<DEL>","chr20",4947111,1345,"Macaque",1,4948456
"chr14:8106149:<DEL>:541:24482.78","<DEL>","chr14",8106149,541,"Macaque",1,8106690
"chr5:52013933:<DEL>:1807:18577.26","<DEL>","chr5",52013933,1807,"Macaque",1,52015740
"chr2:104553875:<DEL>:1089:25733.93","<DEL>","chr2",104553875,1089,"Macaque",1,104554964
"chr9:112257514:<DEL>:851:22152.01","<DEL>","chr9",112257514,851,"Macaque",1,112258365
"chr11:113513377:<DEL>:953:68715.69","<DEL>","chr11",113513377,953,"Macaque",1,113514330
"chrX:66802244:<DEL>:902:23829.17","<DEL>","chrX",66802244,902,"Macaque",1,66803146
"chr9:40378094:<DEL>:879:12957.41","<DEL>","chr9",40378094,879,"Macaque",1,40378973
"chr20:51453382:<DEL>:1024:41498.68","<DEL>","chr20",51453382,1024,"Macaque",1,51454406
"chr11:30874446:<DEL>:4723:18796.15","<DEL>","chr11",30874446,4723,"Macaque",1,30879169
"chr15:70622934:<DEL>:1227:9220.02","<DEL>","chr15",70622934,1227,"Macaque",1,70624161
"chr15:43645633:<DEL>:612:25327.39","<DEL>","chr15",43645633,612,"Macaque",1,43646245
"chr9:5420383:<DEL>:812:23307.29","<DEL>","chr9",5420383,812,"Macaque",1,5421195
"chr20:31886797:<DEL>:587:70300.98","<DEL>","chr20",31886797,587,"Macaque",1,31887384
"chr2:189520148:<DEL>:497:46507.55","<DEL>","chr2",189520148,497,"Macaque",1,189520645
"chr6:168741022:<DEL>:647:16420.16","<DEL>","chr6",168741022,647,"Macaque",1,168741669
"chrX:32588424:<DEL>:1407:24475.87","<DEL>","chrX",32588424,1407,"Macaque",1,32589831
"chr2:14218288:<DEL>:920:40295.88","<DEL>","chr2",14218288,920,"Macaque",1,14219208
"chr18:8652108:<DEL>:1333:17728.42","<DEL>","chr18",8652108,1333,"Macaque",1,8653441
"chr20:33498245:<DEL>:1522:19439.01","<DEL>","chr20",33498245,1522,"Macaque",1,33499767
"chr1:21359427:<DEL>:811:40798.09","<DEL>","chr1",21359427,811,"Macaque",1,21360238
"chr19:7657476:<DEL>:793:7236.28","<DEL>","chr19",7657476,793,"Macaque",1,7658269
"chr4:98868004:<DEL>:36677:25376.94","<DEL>","chr4",98868004,36677,"Macaque",1,98904681
"chr19:3840766:<DEL>:823:7347.84","<DEL>","chr19",3840766,823,"Macaque",1,3841589
"chr15:14216694:<DEL>:1844:46848.96","<DEL>","chr15",14216694,1844,"Macaque",1,14218538
"chr6:32389807:<DEL>:691:7743.71","<DEL>","chr6",32389807,691,"Macaque",1,32390498
"chr2:104274186:<DEL>:1391:43817.42","<DEL>","chr2",104274186,1391,"Macaque",1,104275577
"chr7:118757591:<DEL>:508:16272.33","<DEL>","chr7",118757591,508,"Macaque",1,118758099
"chr11:120580316:<DEL>:1121:30960.13","<DEL>","chr11",120580316,1121,"Macaque",1,120581437
"chr20:72856109:<DEL>:567:17544.3","<DEL>","chr20",72856109,567,"Macaque",1,72856676
"chr7:46462816:<DEL>:980:25918.76","<DEL>","chr7",46462816,980,"Macaque",1,46463796
"chr7:93472175:<DEL>:757:41503.84","<DEL>","chr7",93472175,757,"Macaque",1,93472932
"chr4:61976867:<DEL>:858:9314.58","<DEL>","chr4",61976867,858,"Macaque",1,61977725
"chr16:49746364:<DEL>:1386:42501.56","<DEL>","chr16",49746364,1386,"Macaque",1,49747750
"chr14:1011459:<DEL>:1001:20798.3","<DEL>","chr14",1011459,1001,"Macaque",1,1012460
"chr8:141844500:<DEL>:727:3553.39","<DEL>","chr8",141844500,727,"Macaque",1,141845227
"chr8:101526687:<DEL>:6759:15844.04","<DEL>","chr8",101526687,6759,"Macaque",1,101533446
"chr12:19833740:<DEL>:452:25853.6","<DEL>","chr12",19833740,452,"Macaque",1,19834192
"chr8:142786005:<DEL>:647:17672.01","<DEL>","chr8",142786005,647,"Macaque",1,142786652
"chr16:76410008:<DEL>:1039:9699.86","<DEL>","chr16",76410008,1039,"Macaque",1,76411047
"chr7:162292740:<DEL>:1746:38411.85","<DEL>","chr7",162292740,1746,"Macaque",1,162294486
"chr3:64586895:<DEL>:1140:10981.62","<DEL>","chr3",64586895,1140,"Macaque",1,64588035
"chr5:150178901:<DEL>:836:32775.18","<DEL>","chr5",150178901,836,"Macaque",1,150179737
"chr17:38091816:<DEL>:2683:43910.81","<DEL>","chr17",38091816,2683,"Macaque",1,38094499
"chr18:27501423:<DEL>:1636:64757.0","<DEL>","chr18",27501423,1636,"Macaque",1,27503059
"chr4:307336:<DEL>:911:40945.8","<DEL>","chr4",307336,911,"Macaque",1,308247
"chr15:4291288:<DEL>:541:52986.88","<DEL>","chr15",4291288,541,"Macaque",1,4291829
"chr7:166595336:<DEL>:2660:46736.11","<DEL>","chr7",166595336,2660,"Macaque",1,166597996
"chr11:131608700:<DEL>:2484:16277.94","<DEL>","chr11",131608700,2484,"Macaque",1,131611184
"chr16:28592495:<DEL>:2710:25140.66","<DEL>","chr16",28592495,2710,"Macaque",1,28595205
"chr13:91450152:<DEL>:775:10337.26","<DEL>","chr13",91450152,775,"Macaque",1,91450927
"chr10:59025412:<DEL>:522:38736.97","<DEL>","chr10",59025412,522,"Macaque",1,59025934
"chr16:1987581:<DEL>:636:16897.2","<DEL>","chr16",1987581,636,"Macaque",1,1988217
"chr4:163920519:<DEL>:492:12721.65","<DEL>","chr4",163920519,492,"Macaque",1,163921011
"chr5:129956852:<DEL>:843:27976.69","<DEL>","chr5",129956852,843,"Macaque",1,129957695
"chr9:88470249:<DEL>:1726:31462.68","<DEL>","chr9",88470249,1726,"Macaque",1,88471975
"chr6:162372874:<DEL>:1094:18451.24","<DEL>","chr6",162372874,1094,"Macaque",1,162373968
"chr5:55730156:<DEL>:1413:11118.52","<DEL>","chr5",55730156,1413,"Macaque",1,55731569
"chr16:20228589:<DEL>:8184:43096.58","<DEL>","chr16",20228589,8184,"Macaque",1,20236773
"chr3:17877438:<DEL>:941:14646.83","<DEL>","chr3",17877438,941,"Macaque",1,17878379
"chr10:70138137:<DEL>:555:18749.62","<DEL>","chr10",70138137,555,"Macaque",1,70138692
"chr3:34107105:<DUP>:394:10008.04","<DUP>","chr3",34107105,394,"Macaque",1,34107499
"chr12:660462:<DEL>:1852:33501.13","<DEL>","chr12",660462,1852,"Macaque",1,662314
"chr10:1897395:<DEL>:9645:4838.06","<DEL>","chr10",1897395,9645,"Macaque",1,1907040
"chr1:134943258:<DEL>:670:34336.6","<DEL>","chr1",134943258,670,"Macaque",1,134943928
"chr6:57460726:<DEL>:382:57971.35","<DEL>","chr6",57460726,382,"Macaque",1,57461108
"chr10:59792855:<DEL>:319:20064.71","<DEL>","chr10",59792855,319,"Macaque",1,59793174
"chr1:60650200:<DEL>:488:12194.43","<DEL>","chr1",60650200,488,"Macaque",1,60650688
"chr2:62839888:<DEL>:608:24487.77","<DEL>","chr2",62839888,608,"Macaque",1,62840496
"chr20:20860045:<DEL>:635:11633.16","<DEL>","chr20",20860045,635,"Macaque",1,20860680
"chr2:202618352:<DEL>:542:21702.81","<DEL>","chr2",202618352,542,"Macaque",1,202618894
"chr17:95229786:<DUP>:822:10951.9","<DUP>","chr17",95229786,822,"Macaque",1,95230608
"chr20:12520787:<DEL>:610:22007.57","<DEL>","chr20",12520787,610,"Macaque",1,12521397
"chr19:4582717:<DEL>:665:16432.92","<DEL>","chr19",4582717,665,"Macaque",1,4583382
"chr8:8681282:<DEL>:593:48816.29","<DEL>","chr8",8681282,593,"Macaque",1,8681875
"chr19:9522692:<DEL>:4323:55096.61","<DEL>","chr19",9522692,4323,"Macaque",1,9527015
"chr1:118482787:<DEL>:41717:45761.2","<DEL>","chr1",118482787,41717,"Macaque",1,118524504
"chr1:137965582:<DEL>:446:25785.3","<DEL>","chr1",137965582,446,"Macaque",1,137966028
"chr2:13986021:<DEL>:552:9158.08","<DEL>","chr2",13986021,552,"Macaque",1,13986573
"chr1:115157352:<DEL>:673:13609.3","<DEL>","chr1",115157352,673,"Macaque",1,115158025
"chr13:67481009:<DEL>:1201:27361.07","<DEL>","chr13",67481009,1201,"Macaque",1,67482210
"chr20:2365925:<DEL>:1372:32038.34","<DEL>","chr20",2365925,1372,"Macaque",1,2367297
"chr16:68051386:<DEL>:5605:25642.82","<DEL>","chr16",68051386,5605,"Macaque",1,68056991
"chrX:103788197:<DEL>:1434:8742.52","<DEL>","chrX",103788197,1434,"Macaque",1,103789631
"chr1:84901699:<DEL>:5641:49749.42","<DEL>","chr1",84901699,5641,"Macaque",1,84907340
"chr3:184794659:<DUP>:525:25369.6","<DUP>","chr3",184794659,525,"Macaque",1,184795184
"chr16:73112720:<DEL>:625:16970.2","<DEL>","chr16",73112720,625,"Macaque",1,73113345
"chr17:4622242:<DEL>:2479:55835.17","<DEL>","chr17",4622242,2479,"Macaque",1,4624721
"chr7:43819527:<DEL>:4410:47248.79","<DEL>","chr7",43819527,4410,"Macaque",1,43823937
"chr6:43741386:<DEL>:4123:13440.01","<DEL>","chr6",43741386,4123,"Macaque",1,43745509
"chr15:44439221:<DEL>:526:71166.36","<DEL>","chr15",44439221,526,"Macaque",1,44439747
"chr6:53714382:<DEL>:699:48685.91","<DEL>","chr6",53714382,699,"Macaque",1,53715081
"chr7:67432218:<DEL>:4841:12561.48","<DEL>","chr7",67432218,4841,"Macaque",1,67437059
"chr8:141536271:<DEL>:376:41799.55","<DEL>","chr8",141536271,376,"Macaque",1,141536647
"chr5:3715765:<DEL>:848:11830.75","<DEL>","chr5",3715765,848,"Macaque",1,3716613
"chr7:146934040:<DEL>:39456:52190.6","<DEL>","chr7",146934040,39456,"Macaque",1,146973496
"chr14:10583536:<DEL>:1433:39556.85","<DEL>","chr14",10583536,1433,"Macaque",1,10584969
"chr11:25936302:<DEL>:396:19054.31","<DEL>","chr11",25936302,396,"Macaque",1,25936698
"chr19:347870:<DEL>:2387:29932.41","<DEL>","chr19",347870,2387,"Macaque",1,350257
"chr7:156133203:<DEL>:655:27514.65","<DEL>","chr7",156133203,655,"Macaque",1,156133858
"chr10:67352138:<DEL>:507:14561.78","<DEL>","chr10",67352138,507,"Macaque",1,67352645
"chr3:3234571:<DEL>:884:26849.45","<DEL>","chr3",3234571,884,"Macaque",1,3235455
"chr16:58674087:<DEL>:1363:27525.37","<DEL>","chr16",58674087,1363,"Macaque",1,58675450
"chr11:103909710:<DEL>:50790:17978.71","<DEL>","chr11",103909710,50790,"Macaque",1,103960500
"chr9:5431807:<DEL>:427:14959.6","<DEL>","chr9",5431807,427,"Macaque",1,5432234
"chr9:128362121:<DEL>:3012:17749.53","<DEL>","chr9",128362121,3012,"Macaque",1,128365133
"chr8:6455585:<DUP>:670:7589.17","<DUP>","chr8",6455585,670,"Macaque",1,6456255
"chr13:68377800:<DEL>:436:22679.09","<DEL>","chr13",68377800,436,"Macaque",1,68378236
"chr1:72636300:<DEL>:2002:23486.24","<DEL>","chr1",72636300,2002,"Macaque",1,72638302
"chr13:63526539:<DEL>:1344:58878.08","<DEL>","chr13",63526539,1344,"Macaque",1,63527883
"chr15:7018459:<DEL>:1050:25540.85","<DEL>","chr15",7018459,1050,"Macaque",1,7019509
"chr12:125177868:<DEL>:467:6550.75","<DEL>","chr12",125177868,467,"Macaque",1,125178335
"chr12:71237824:<DEL>:865:9840.16","<DEL>","chr12",71237824,865,"Macaque",1,71238689
"chr15:2872800:<DEL>:603:14314.96","<DEL>","chr15",2872800,603,"Macaque",1,2873403
"chr15:27846858:<DUP>:45942:47302.28","<DUP>","chr15",27846858,45942,"Macaque",1,27892800
"chr5:174236413:<DEL>:857:12402.16","<DEL>","chr5",174236413,857,"Macaque",1,174237270
"chr14:89368931:<DEL>:699:9537.92","<DEL>","chr14",89368931,699,"Macaque",1,89369630
"chrX:709607:<DEL>:874:16869.94","<DEL>","chrX",709607,874,"Macaque",1,710481
"chr18:9562430:<DEL>:1972:36610.98","<DEL>","chr18",9562430,1972,"Macaque",1,9564402
"chr12:113834773:<DUP>:424:5823.62","<DUP>","chr12",113834773,424,"Macaque",1,113835197
"chr6:977761:<DEL>:857:14804.45","<DEL>","chr6",977761,857,"Macaque",1,978618
"chr4:127866832:<DEL>:1578:10046.07","<DEL>","chr4",127866832,1578,"Macaque",1,127868410
"chr12:10224028:<DEL>:1004:8575.22","<DEL>","chr12",10224028,1004,"Macaque",1,10225032
"chr5:80809426:<DEL>:40845:46056.67","<DEL>","chr5",80809426,40845,"Macaque",1,80850271
"chr10:188090:<DEL>:812:19253.91","<DEL>","chr10",188090,812,"Macaque",1,188902
"chr15:110008998:<DEL>:881:20533.87","<DEL>","chr15",110008998,881,"Macaque",1,110009879
"chr12:71454204:<DEL>:996:7208.99","<DEL>","chr12",71454204,996,"Macaque",1,71455200
"chr12:29406706:<DEL>:3210:59793.87","<DEL>","chr12",29406706,3210,"Macaque",1,29409916
"chr16:76686514:<DEL>:809:54290.76","<DEL>","chr16",76686514,809,"Macaque",1,76687323
"chr10:86180711:<DEL>:381:42655.29","<DEL>","chr10",86180711,381,"Macaque",1,86181092
"chr5:129957207:<DEL>:1688:33202.59","<DEL>","chr5",129957207,1688,"Macaque",1,129958895
"chr11:89557:<DEL>:6510:12744.0","<DEL>","chr11",89557,6510,"Macaque",1,96067
"chr19:37678063:<DEL>:866:36780.35","<DEL>","chr19",37678063,866,"Macaque",1,37678929
"chr10:1356223:<DEL>:3418:39664.55","<DEL>","chr10",1356223,3418,"Macaque",1,1359641
"chr1:1865849:<DEL>:773:44513.34","<DEL>","chr1",1865849,773,"Macaque",1,1866622
"chr6:932461:<DEL>:928:50340.29","<DEL>","chr6",932461,928,"Macaque",1,933389
"chr16:3532938:<DEL>:792:27356.29","<DEL>","chr16",3532938,792,"Macaque",1,3533730
"chr1:1719508:<DEL>:569:49015.56","<DEL>","chr1",1719508,569,"Macaque",1,1720077
"chr15:12751441:<DEL>:36958:8304.05","<DEL>","chr15",12751441,36958,"Macaque",1,12788399
"chr7:125143817:<DEL>:497:30172.4","<DEL>","chr7",125143817,497,"Macaque",1,125144314
"chr3:63703318:<DUP>:461:9286.51","<DUP>","chr3",63703318,461,"Macaque",1,63703779
"chr19:8962517:<DUP>:3129:9955.99","<DUP>","chr19",8962517,3129,"Macaque",1,8965646
"chr20:11558304:<DEL>:580:40316.86","<DEL>","chr20",11558304,580,"Macaque",1,11558884
"chr6:24641916:<DEL>:758:15777.16","<DEL>","chr6",24641916,758,"Macaque",1,24642674
"chr1:205319330:<DEL>:1040:16027.16","<DEL>","chr1",205319330,1040,"Macaque",1,205320370
"chr10:66429946:<DEL>:1921:42237.88","<DEL>","chr10",66429946,1921,"Macaque",1,66431867
"chrX:63437265:<DEL>:788:19971.35","<DEL>","chrX",63437265,788,"Macaque",1,63438053
"chr16:23145521:<DEL>:302:62794.7","<DEL>","chr16",23145521,302,"Macaque",1,23145823
"chr12:63129274:<DEL>:616:48099.83","<DEL>","chr12",63129274,616,"Macaque",1,63129890
"chrX:63519250:<DEL>:616:33222.37","<DEL>","chrX",63519250,616,"Macaque",1,63519866
"chr6:172831645:<DUP>:667:17400.66","<DUP>","chr6",172831645,667,"Macaque",1,172832312
"chr8:51794099:<DEL>:930:10360.44","<DEL>","chr8",51794099,930,"Macaque",1,51795029
"chr13:106704207:<DEL>:1112:39147.39","<DEL>","chr13",106704207,1112,"Macaque",1,106705319
"chr5:69966049:<DEL>:794:18265.41","<DEL>","chr5",69966049,794,"Macaque",1,69966843
"chr19:20693661:<DEL>:1040:14189.06","<DEL>","chr19",20693661,1040,"Macaque",1,20694701
"chr1:164559283:<DEL>:554:39944.16","<DEL>","chr1",164559283,554,"Macaque",1,164559837
"chr13:87522209:<DEL>:820:9644.58","<DEL>","chr13",87522209,820,"Macaque",1,87523029
"chr13:71809040:<DEL>:589:55884.29","<DEL>","chr13",71809040,589,"Macaque",1,71809629
"chr9:10819227:<DEL>:912:42396.33","<DEL>","chr9",10819227,912,"Macaque",1,10820139
"chr9:2946449:<DUP>:621:21033.25","<DUP>","chr9",2946449,621,"Macaque",1,2947070
"chr6:177849638:<DEL>:4256:25224.58","<DEL>","chr6",177849638,4256,"Macaque",1,177853894
"chr1:172621129:<DEL>:1622:33028.51","<DEL>","chr1",172621129,1622,"Macaque",1,172622751
"chr12:98952962:<DEL>:918:30277.83","<DEL>","chr12",98952962,918,"Macaque",1,98953880
"chr13:89727932:<DEL>:1515:35422.13","<DEL>","chr13",89727932,1515,"Macaque",1,89729447
"chr11:54416918:<DEL>:626:38050.63","<DEL>","chr11",54416918,626,"Macaque",1,54417544
"chr13:2189709:<DEL>:646:6959.08","<DEL>","chr13",2189709,646,"Macaque",1,2190355
"chr19:49474019:<DEL>:3779:18671.75","<DEL>","chr19",49474019,3779,"Macaque",1,49477798
"chr3:53145432:<DEL>:907:26263.23","<DEL>","chr3",53145432,907,"Macaque",1,53146339
"chr8:9662931:<DEL>:626:9376.72","<DEL>","chr8",9662931,626,"Macaque",1,9663557
"chr11:120477094:<DEL>:808:8247.73","<DEL>","chr11",120477094,808,"Macaque",1,120477902
"chr16:58579871:<DEL>:674:61507.33","<DEL>","chr16",58579871,674,"Macaque",1,58580545
"chr12:125065557:<DEL>:37504:11752.75","<DEL>","chr12",125065557,37504,"Macaque",1,125103061
"chr7:159414977:<DEL>:860:37164.38","<DEL>","chr7",159414977,860,"Macaque",1,159415837
"chr16:3846449:<DUP>:493:13706.36","<DUP>","chr16",3846449,493,"Macaque",1,3846942
"chr2:18180026:<DEL>:707:34741.91","<DEL>","chr2",18180026,707,"Macaque",1,18180733
"chr6:162618592:<DEL>:1139:13571.88","<DEL>","chr6",162618592,1139,"Macaque",1,162619731
"chr18:25331714:<DEL>:2098:34454.3","<DEL>","chr18",25331714,2098,"Macaque",1,25333812
"chr8:142496457:<DEL>:2014:8584.94","<DEL>","chr8",142496457,2014,"Macaque",1,142498471
"chr8:69978500:<DEL>:46315:11319.1","<DEL>","chr8",69978500,46315,"Macaque",1,70024815
"chr9:129605081:<DEL>:1576:81212.08","<DEL>","chr9",129605081,1576,"Macaque",1,129606657
"chr13:10884583:<DEL>:445:33627.59","<DEL>","chr13",10884583,445,"Macaque",1,10885028
"chr4:32503462:<DEL>:875:72438.04","<DEL>","chr4",32503462,875,"Macaque",1,32504337
"chr9:77211348:<DEL>:394:20496.8","<DEL>","chr9",77211348,394,"Macaque",1,77211742
"chr5:87133680:<DEL>:405:17505.83","<DEL>","chr5",87133680,405,"Macaque",1,87134085
"chr6:58692605:<DEL>:1559:18204.03","<DEL>","chr6",58692605,1559,"Macaque",1,58694164
"chr9:104780414:<DEL>:6070:35573.51","<DEL>","chr9",104780414,6070,"Macaque",1,104786484
"chr6:177977283:<DEL>:963:13146.53","<DEL>","chr6",177977283,963,"Macaque",1,177978246
"chr19:28348045:<DEL>:1281:45378.71","<DEL>","chr19",28348045,1281,"Macaque",1,28349326
"chr10:3219266:<DEL>:39023:22777.22","<DEL>","chr10",3219266,39023,"Macaque",1,3258289
"chr14:123866949:<DEL>:525:63804.72","<DEL>","chr14",123866949,525,"Macaque",1,123867474
"chr11:77864669:<DEL>:329:25339.0","<DEL>","chr11",77864669,329,"Macaque",1,77864998
"chr11:122112282:<DEL>:2145:21573.24","<DEL>","chr11",122112282,2145,"Macaque",1,122114427
"chr7:165238189:<DEL>:702:3679.95","<DEL>","chr7",165238189,702,"Macaque",1,165238891
"chr8:28455301:<DEL>:682:28862.98","<DEL>","chr8",28455301,682,"Macaque",1,28455983
"chr4:150420373:<DEL>:6729:31178.97","<DEL>","chr4",150420373,6729,"Macaque",1,150427102
"chr1:14920978:<DEL>:1020:47858.73","<DEL>","chr1",14920978,1020,"Macaque",1,14921998
"chr1:8700818:<DEL>:1762:34741.87","<DEL>","chr1",8700818,1762,"Macaque",1,8702580
"chr15:91357812:<DEL>:1009:27798.91","<DEL>","chr15",91357812,1009,"Macaque",1,91358821
"chr3:82008920:<DEL>:681:50339.88","<DEL>","chr3",82008920,681,"Macaque",1,82009601
"chr11:53875714:<DEL>:1011:33758.37","<DEL>","chr11",53875714,1011,"Macaque",1,53876725
"chr4:93978287:<DEL>:763:56426.04","<DEL>","chr4",93978287,763,"Macaque",1,93979050
"chr14:80094049:<DEL>:591:23783.56","<DEL>","chr14",80094049,591,"Macaque",1,80094640
"chr2:202486137:<DEL>:4926:10090.97","<DEL>","chr2",202486137,4926,"Macaque",1,202491063
"chr16:16949642:<DEL>:816:30369.62","<DEL>","chr16",16949642,816,"Macaque",1,16950458
"chr6:26702673:<DEL>:615:17023.0","<DEL>","chr6",26702673,615,"Macaque",1,26703288
"chr11:132838094:<DEL>:7917:7334.49","<DEL>","chr11",132838094,7917,"Macaque",1,132846011
"chr5:49643873:<DEL>:911:39586.82","<DEL>","chr5",49643873,911,"Macaque",1,49644784
"chr5:132698478:<DEL>:592:11463.47","<DEL>","chr5",132698478,592,"Macaque",1,132699070
"chr14:1027063:<DUP>:698:48091.55","<DUP>","chr14",1027063,698,"Macaque",1,1027761
"chr19:1861939:<DEL>:5845:17312.01","<DEL>","chr19",1861939,5845,"Macaque",1,1867784
"chr16:73008677:<DEL>:3243:41683.93","<DEL>","chr16",73008677,3243,"Macaque",1,73011920
"chr7:161788563:<DEL>:615:14405.83","<DEL>","chr7",161788563,615,"Macaque",1,161789178
"chr9:109273881:<DEL>:966:42038.87","<DEL>","chr9",109273881,966,"Macaque",1,109274847
"chr2:75897615:<DEL>:533:20755.92","<DEL>","chr2",75897615,533,"Macaque",1,75898148
"chr10:88910458:<DEL>:886:16248.38","<DEL>","chr10",88910458,886,"Macaque",1,88911344
"chr5:105892978:<DEL>:646:9179.08","<DEL>","chr5",105892978,646,"Macaque",1,105893624
"chr6:159611798:<DEL>:1169:33024.08","<DEL>","chr6",159611798,1169,"Macaque",1,159612967
"chr13:107604631:<DEL>:725:14134.3","<DEL>","chr13",107604631,725,"Macaque",1,107605356
"chr7:62068804:<DEL>:2408:17184.23","<DEL>","chr7",62068804,2408,"Macaque",1,62071212
"chr6:152532532:<DEL>:980:28507.99","<DEL>","chr6",152532532,980,"Macaque",1,152533512
"chr1:124502690:<DEL>:692:8292.01","<DEL>","chr1",124502690,692,"Macaque",1,124503382
"chr11:125077711:<DEL>:585:21768.35","<DEL>","chr11",125077711,585,"Macaque",1,125078296
"chr16:3495153:<DEL>:1675:26213.16","<DEL>","chr16",3495153,1675,"Macaque",1,3496828
"chr18:50240795:<DEL>:3113:24689.27","<DEL>","chr18",50240795,3113,"Macaque",1,50243908
"chr20:43915832:<DEL>:814:21192.95","<DEL>","chr20",43915832,814,"Macaque",1,43916646
"chr7:165279169:<DEL>:1324:20132.36","<DEL>","chr7",165279169,1324,"Macaque",1,165280493
"chr11:133639368:<DEL>:554:53135.06","<DEL>","chr11",133639368,554,"Macaque",1,133639922
"chr17:45820061:<DEL>:911:26056.43","<DEL>","chr17",45820061,911,"Macaque",1,45820972
"chr5:6577855:<DEL>:2780:15755.16","<DEL>","chr5",6577855,2780,"Macaque",1,6580635
"chr11:108485448:<DUP>:209:15146.31","<DUP>","chr11",108485448,209,"Macaque",1,108485657
"chr3:24920812:<DEL>:651:21039.98","<DEL>","chr3",24920812,651,"Macaque",1,24921463
"chr2:98223237:<DEL>:672:14276.8","<DEL>","chr2",98223237,672,"Macaque",1,98223909
"chr5:409266:<DEL>:246:5811.91","<DEL>","chr5",409266,246,"Macaque",1,409512
"chr1:98510408:<DEL>:1852:29004.01","<DEL>","chr1",98510408,1852,"Macaque",1,98512260
"chr11:73762244:<DEL>:2040:17873.42","<DEL>","chr11",73762244,2040,"Macaque",1,73764284
"chr11:122396230:<DEL>:3229:41211.64","<DEL>","chr11",122396230,3229,"Macaque",1,122399459
"chr14:60948:<DEL>:628:11653.35","<DEL>","chr14",60948,628,"Macaque",1,61576
"chr19:45835893:<DEL>:600:31001.71","<DEL>","chr19",45835893,600,"Macaque",1,45836493
"chr7:44758409:<DEL>:45007:52733.73","<DEL>","chr7",44758409,45007,"Macaque",1,44803416
"chr11:132041445:<DEL>:20560:26545.89","<DEL>","chr11",132041445,20560,"Macaque",1,132062005
"chr10:84004836:<DEL>:459:33299.55","<DEL>","chr10",84004836,459,"Macaque",1,84005295
"chr7:167862756:<DEL>:673:58612.17","<DEL>","chr7",167862756,673,"Macaque",1,167863429
"chr3:672541:<DEL>:3392:15923.46","<DEL>","chr3",672541,3392,"Macaque",1,675933
"chr7:77011996:<DEL>:1613:47273.22","<DEL>","chr7",77011996,1613,"Macaque",1,77013609
"chr3:112043000:<DEL>:4855:27955.31","<DEL>","chr3",112043000,4855,"Macaque",1,112047855
"chr12:55418405:<DEL>:704:45702.12","<DEL>","chr12",55418405,704,"Macaque",1,55419109
"chr6:11958444:<DEL>:4004:36843.86","<DEL>","chr6",11958444,4004,"Macaque",1,11962448
"chr19:18690471:<DEL>:504:11508.07","<DEL>","chr19",18690471,504,"Macaque",1,18690975
"chr5:188491371:<DEL>:1025:14150.93","<DEL>","chr5",188491371,1025,"Macaque",1,188492396
"chr10:59098358:<DEL>:2211:11545.3","<DEL>","chr10",59098358,2211,"Macaque",1,59100569
"chr11:37675096:<DEL>:487:27602.61","<DEL>","chr11",37675096,487,"Macaque",1,37675583
"chr8:14377619:<DEL>:42353:51709.46","<DEL>","chr8",14377619,42353,"Macaque",1,14419972
"chr3:155858125:<DEL>:650:40857.15","<DEL>","chr3",155858125,650,"Macaque",1,155858775
"chr6:229396:<DEL>:822:6503.97","<DEL>","chr6",229396,822,"Macaque",1,230218
"chr3:153834183:<DEL>:435:78764.31","<DEL>","chr3",153834183,435,"Macaque",1,153834618
"chr8:112048352:<DEL>:508:55185.27","<DEL>","chr8",112048352,508,"Macaque",1,112048860
"chr19:13621880:<DEL>:2676:29845.68","<DEL>","chr19",13621880,2676,"Macaque",1,13624556
"chr16:9022718:<DEL>:526:28780.01","<DEL>","chr16",9022718,526,"Macaque",1,9023244
"chr13:51433769:<DEL>:2893:34999.76","<DEL>","chr13",51433769,2893,"Macaque",1,51436662
"chr10:439382:<DUP>:559:49557.38","<DUP>","chr10",439382,559,"Macaque",1,439941
"chr16:75814824:<DEL>:404:44063.26","<DEL>","chr16",75814824,404,"Macaque",1,75815228
"chr9:115394158:<DEL>:1286:46999.36","<DEL>","chr9",115394158,1286,"Macaque",1,115395444
"chr3:183414567:<DEL>:494:47386.06","<DEL>","chr3",183414567,494,"Macaque",1,183415061
"chr4:129918551:<DEL>:1920:48439.15","<DEL>","chr4",129918551,1920,"Macaque",1,129920471
"chr1:139393686:<DEL>:1057:32303.02","<DEL>","chr1",139393686,1057,"Macaque",1,139394743
"chr10:33217246:<DEL>:770:45524.88","<DEL>","chr10",33217246,770,"Macaque",1,33218016
"chr11:132975874:<DEL>:618:43953.56","<DEL>","chr11",132975874,618,"Macaque",1,132976492
"chr4:162855996:<DEL>:576:12616.36","<DEL>","chr4",162855996,576,"Macaque",1,162856572
"chr9:125237028:<DEL>:3360:39320.95","<DEL>","chr9",125237028,3360,"Macaque",1,125240388
"chr2:85415647:<DEL>:688:35471.69","<DEL>","chr2",85415647,688,"Macaque",1,85416335
"chr1:192601377:<DEL>:1137:32466.69","<DEL>","chr1",192601377,1137,"Macaque",1,192602514
"chr5:121896393:<DEL>:2130:38687.45","<DEL>","chr5",121896393,2130,"Macaque",1,121898523
"chr9:38668952:<DEL>:777:11413.01","<DEL>","chr9",38668952,777,"Macaque",1,38669729
"chr19:2196263:<DEL>:1727:43864.47","<DEL>","chr19",2196263,1727,"Macaque",1,2197990
"chr15:2240522:<DEL>:545:14328.78","<DEL>","chr15",2240522,545,"Macaque",1,2241067
"chr5:167345587:<DEL>:2123:47947.35","<DEL>","chr5",167345587,2123,"Macaque",1,167347710
"chr10:15253194:<DEL>:2095:35613.74","<DEL>","chr10",15253194,2095,"Macaque",1,15255289
"chr8:142207421:<DEL>:663:45418.24","<DEL>","chr8",142207421,663,"Macaque",1,142208084
"chr11:2291085:<DEL>:8420:35480.42","<DEL>","chr11",2291085,8420,"Macaque",1,2299505
"chr3:40996972:<DEL>:794:69661.01","<DEL>","chr3",40996972,794,"Macaque",1,40997766
"chr15:104012074:<DEL>:2893:10476.75","<DEL>","chr15",104012074,2893,"Macaque",1,104014967
"chr1:176996463:<DEL>:1264:18257.26","<DEL>","chr1",176996463,1264,"Macaque",1,176997727
"chr12:30922010:<DEL>:533:28760.08","<DEL>","chr12",30922010,533,"Macaque",1,30922543
"chr17:92558327:<DEL>:2885:34759.95","<DEL>","chr17",92558327,2885,"Macaque",1,92561212
"chr6:82132652:<DEL>:410:7503.72","<DEL>","chr6",82132652,410,"Macaque",1,82133062
"chr19:12961000:<DEL>:1081:23446.69","<DEL>","chr19",12961000,1081,"Macaque",1,12962081
"chr9:14409910:<DEL>:780:37400.73","<DEL>","chr9",14409910,780,"Macaque",1,14410690
"chr11:51676283:<DEL>:635:47907.36","<DEL>","chr11",51676283,635,"Macaque",1,51676918
"chr10:18379290:<DEL>:1788:7218.82","<DEL>","chr10",18379290,1788,"Macaque",1,18381078
"chr13:91798562:<DEL>:23818:28367.73","<DEL>","chr13",91798562,23818,"Macaque",1,91822380
"chr6:165023660:<DEL>:258:31509.46","<DEL>","chr6",165023660,258,"Macaque",1,165023918
"chr18:53125072:<DEL>:744:5846.49","<DEL>","chr18",53125072,744,"Macaque",1,53125816
"chr2:13335787:<DEL>:9722:6453.82","<DEL>","chr2",13335787,9722,"Macaque",1,13345509
"chr11:132333525:<DEL>:1856:47061.06","<DEL>","chr11",132333525,1856,"Macaque",1,132335381
"chr2:129135903:<DEL>:735:42806.97","<DEL>","chr2",129135903,735,"Macaque",1,129136638
"chr10:1262244:<DUP>:678:14049.33","<DUP>","chr10",1262244,678,"Macaque",1,1262922
"chr2:63564070:<DEL>:550:28318.7","<DEL>","chr2",63564070,550,"Macaque",1,63564620
"chr10:26549962:<DEL>:963:29682.66","<DEL>","chr10",26549962,963,"Macaque",1,26550925
"chr6:60983523:<DEL>:535:30417.09","<DEL>","chr6",60983523,535,"Macaque",1,60984058
"chr3:127902610:<DEL>:667:13438.53","<DEL>","chr3",127902610,667,"Macaque",1,127903277
"chr11:17481379:<DEL>:4434:31758.08","<DEL>","chr11",17481379,4434,"Macaque",1,17485813
"chr15:108064823:<DUP>:340:6605.89","<DUP>","chr15",108064823,340,"Macaque",1,108065163
"chr10:1616732:<DEL>:1313:79675.93","<DEL>","chr10",1616732,1313,"Macaque",1,1618045
"chr13:92498276:<DEL>:3196:31574.06","<DEL>","chr13",92498276,3196,"Macaque",1,92501472
"chr13:13532623:<DEL>:327:24885.93","<DEL>","chr13",13532623,327,"Macaque",1,13532950
"chr6:1480469:<DEL>:428:37641.36","<DEL>","chr6",1480469,428,"Macaque",1,1480897
"chr12:123848591:<DEL>:1210:41628.41","<DEL>","chr12",123848591,1210,"Macaque",1,123849801
"chr19:37476657:<DEL>:325:19129.07","<DEL>","chr19",37476657,325,"Macaque",1,37476982
"chr17:42544283:<DEL>:933:52615.05","<DEL>","chr17",42544283,933,"Macaque",1,42545216
"chr20:72699243:<DEL>:1088:50582.63","<DEL>","chr20",72699243,1088,"Macaque",1,72700331
"chr4:172080325:<DEL>:881:32880.71","<DEL>","chr4",172080325,881,"Macaque",1,172081206
"chr18:37614604:<DEL>:764:22411.4","<DEL>","chr18",37614604,764,"Macaque",1,37615368
"chr3:162946475:<DEL>:1169:22829.64","<DEL>","chr3",162946475,1169,"Macaque",1,162947644
"chr6:2904643:<DEL>:607:39126.35","<DEL>","chr6",2904643,607,"Macaque",1,2905250
"chr16:31612199:<DEL>:704:28402.36","<DEL>","chr16",31612199,704,"Macaque",1,31612903
"chr11:30038695:<DEL>:923:17668.49","<DEL>","chr11",30038695,923,"Macaque",1,30039618
"chr12:90662918:<DEL>:1000:58109.96","<DEL>","chr12",90662918,1000,"Macaque",1,90663918
"chr1:69144963:<DEL>:812:50504.81","<DEL>","chr1",69144963,812,"Macaque",1,69145775
"chr18:10624797:<DEL>:705:16002.72","<DEL>","chr18",10624797,705,"Macaque",1,10625502
"chr15:14718285:<DEL>:4155:15014.91","<DEL>","chr15",14718285,4155,"Macaque",1,14722440
"chr18:64524043:<DUP>:755:17783.11","<DUP>","chr18",64524043,755,"Macaque",1,64524798
"chr14:1083911:<DUP>:2020:16682.19","<DUP>","chr14",1083911,2020,"Macaque",1,1085931
"chr3:3126840:<DEL>:728:38146.63","<DEL>","chr3",3126840,728,"Macaque",1,3127568
"chrX:131877551:<DEL>:3350:13434.7","<DEL>","chrX",131877551,3350,"Macaque",1,131880901
"chr1:198919646:<DEL>:38475:42541.05","<DEL>","chr1",198919646,38475,"Macaque",1,198958121
"chr4:168660305:<DEL>:15560:20226.92","<DEL>","chr4",168660305,15560,"Macaque",1,168675865
"chr2:114425834:<DEL>:2468:9690.84","<DEL>","chr2",114425834,2468,"Macaque",1,114428302
"chr1:213939825:<DEL>:7284:23154.87","<DEL>","chr1",213939825,7284,"Macaque",1,213947109
"chr16:57060548:<DEL>:735:22944.05","<DEL>","chr16",57060548,735,"Macaque",1,57061283
"chr12:97473636:<DEL>:49358:24823.35","<DEL>","chr12",97473636,49358,"Macaque",1,97522994
"chr5:3698061:<DUP>:1024:3903.75","<DUP>","chr5",3698061,1024,"Macaque",1,3699085
"chrX:876381:<DEL>:330:25416.46","<DEL>","chrX",876381,330,"Macaque",1,876711
"chr7:163199128:<DEL>:468:68117.29","<DEL>","chr7",163199128,468,"Macaque",1,163199596
"chr12:111267921:<DEL>:38947:10695.33","<DEL>","chr12",111267921,38947,"Macaque",1,111306868
"chr7:103777201:<DEL>:525:35081.07","<DEL>","chr7",103777201,525,"Macaque",1,103777726
"chr8:6360339:<DEL>:1347:25789.6","<DEL>","chr8",6360339,1347,"Macaque",1,6361686
"chr8:96463508:<DEL>:9095:41231.22","<DEL>","chr8",96463508,9095,"Macaque",1,96472603
"chr3:1189133:<DEL>:738:10929.72","<DEL>","chr3",1189133,738,"Macaque",1,1189871
"chr8:137442631:<DEL>:636:37823.92","<DEL>","chr8",137442631,636,"Macaque",1,137443267
"chr2:201266864:<DEL>:2169:42068.45","<DEL>","chr2",201266864,2169,"Macaque",1,201269033
"chr9:88629817:<DEL>:714:14440.24","<DEL>","chr9",88629817,714,"Macaque",1,88630531
"chr16:71660020:<DEL>:559:16758.76","<DEL>","chr16",71660020,559,"Macaque",1,71660579
"chr5:177217063:<DEL>:2174:11017.84","<DEL>","chr5",177217063,2174,"Macaque",1,177219237
"chr17:93783269:<DEL>:1691:64757.03","<DEL>","chr17",93783269,1691,"Macaque",1,93784960
"chr2:35897385:<DEL>:38324:34315.39","<DEL>","chr2",35897385,38324,"Macaque",1,35935709
"chr7:133624542:<DEL>:953:6607.0","<DEL>","chr7",133624542,953,"Macaque",1,133625495
"chr5:135719529:<DEL>:39618:18789.21","<DEL>","chr5",135719529,39618,"Macaque",1,135759147
"chr4:36652318:<DEL>:415:21832.64","<DEL>","chr4",36652318,415,"Macaque",1,36652733
"chr17:92285017:<DEL>:1601:22325.53","<DEL>","chr17",92285017,1601,"Macaque",1,92286618
"chrX:95347762:<DEL>:1605:22960.25","<DEL>","chrX",95347762,1605,"Macaque",1,95349367
"chr10:63202641:<DEL>:986:55480.67","<DEL>","chr10",63202641,986,"Macaque",1,63203627
"chr3:96044707:<DEL>:616:7153.63","<DEL>","chr3",96044707,616,"Macaque",1,96045323
"chr7:56222783:<DEL>:963:30900.79","<DEL>","chr7",56222783,963,"Macaque",1,56223746
"chr5:54258638:<DEL>:713:47464.25","<DEL>","chr5",54258638,713,"Macaque",1,54259351
"chr9:44204609:<DEL>:8857:15172.46","<DEL>","chr9",44204609,8857,"Macaque",1,44213466
"chr6:144877286:<DEL>:643:8775.47","<DEL>","chr6",144877286,643,"Macaque",1,144877929
"chr14:1433001:<DEL>:7411:25809.47","<DEL>","chr14",1433001,7411,"Macaque",1,1440412
"chr19:1375685:<DEL>:631:38020.86","<DEL>","chr19",1375685,631,"Macaque",1,1376316
"chr9:14637352:<DEL>:2479:13241.56","<DEL>","chr9",14637352,2479,"Macaque",1,14639831
"chr9:125238292:<DEL>:2098:18109.54","<DEL>","chr9",125238292,2098,"Macaque",1,125240390
"chr16:26153828:<DEL>:3033:23525.99","<DEL>","chr16",26153828,3033,"Macaque",1,26156861
"chr3:45451332:<DEL>:3129:8612.41","<DEL>","chr3",45451332,3129,"Macaque",1,45454461
"chr13:86702941:<DEL>:5920:37972.66","<DEL>","chr13",86702941,5920,"Macaque",1,86708861
"chr6:52446539:<DEL>:8202:34706.86","<DEL>","chr6",52446539,8202,"Macaque",1,52454741
"chr8:95303477:<DEL>:1189:13038.27","<DEL>","chr8",95303477,1189,"Macaque",1,95304666
"chr6:104486286:<DEL>:3414:23486.25","<DEL>","chr6",104486286,3414,"Macaque",1,104489700
"chr2:147481380:<DEL>:823:24431.6","<DEL>","chr2",147481380,823,"Macaque",1,147482203
"chr5:99276684:<DEL>:383:16504.98","<DEL>","chr5",99276684,383,"Macaque",1,99277067
"chr1:142774099:<DEL>:1736:56987.36","<DEL>","chr1",142774099,1736,"Macaque",1,142775835
"chr17:92285017:<DEL>:891:36080.87","<DEL>","chr17",92285017,891,"Macaque",1,92285908
"chr10:56502498:<DEL>:712:41543.48","<DEL>","chr10",56502498,712,"Macaque",1,56503210
"chr5:80431804:<DUP>:11132:12440.65","<DUP>","chr5",80431804,11132,"Macaque",1,80442936
"chr15:2207992:<DEL>:615:42988.75","<DEL>","chr15",2207992,615,"Macaque",1,2208607
"chr6:11168619:<DEL>:590:9454.26","<DEL>","chr6",11168619,590,"Macaque",1,11169209
"chr3:35621392:<DEL>:1695:12429.83","<DEL>","chr3",35621392,1695,"Macaque",1,35623087
"chr5:105022313:<DEL>:251:31705.67","<DEL>","chr5",105022313,251,"Macaque",1,105022564
"chr18:35499945:<DEL>:682:34401.99","<DEL>","chr18",35499945,682,"Macaque",1,35500627
"chr15:3070868:<DEL>:1118:10998.86","<DEL>","chr15",3070868,1118,"Macaque",1,3071986
"chr13:2689458:<DEL>:2433:14847.11","<DEL>","chr13",2689458,2433,"Macaque",1,2691891
"chr7:62068804:<DEL>:869:28008.19","<DEL>","chr7",62068804,869,"Macaque",1,62069673
"chr15:69772129:<DEL>:60092:41961.78","<DEL>","chr15",69772129,60092,"Macaque",1,69832221
"chr16:3800615:<DEL>:438:61788.78","<DEL>","chr16",3800615,438,"Macaque",1,3801053
"chr17:95230350:<DEL>:1571:19937.41","<DEL>","chr17",95230350,1571,"Macaque",1,95231921
"chr8:41945716:<DEL>:663:12864.04","<DEL>","chr8",41945716,663,"Macaque",1,41946379
"chr11:125137927:<DEL>:670:35598.63","<DEL>","chr11",125137927,670,"Macaque",1,125138597
"chr20:31640871:<DEL>:628:4273.03","<DEL>","chr20",31640871,628,"Macaque",1,31641499
"chr6:117646375:<DEL>:1293:50960.66","<DEL>","chr6",117646375,1293,"Macaque",1,117647668
"chr10:2081897:<DEL>:1577:5959.51","<DEL>","chr10",2081897,1577,"Macaque",1,2083474
"chr9:120241847:<DUP>:756:5641.04","<DUP>","chr9",120241847,756,"Macaque",1,120242603
"chr7:153176120:<DEL>:868:23668.68","<DEL>","chr7",153176120,868,"Macaque",1,153176988
"chr6:152780995:<DEL>:1950:21839.57","<DEL>","chr6",152780995,1950,"Macaque",1,152782945
"chr9:128827266:<DEL>:305:19455.58","<DEL>","chr9",128827266,305,"Macaque",1,128827571
"chr6:27437676:<DEL>:50680:39261.84","<DEL>","chr6",27437676,50680,"Macaque",1,27488356
"chr16:50139863:<DEL>:649:43522.45","<DEL>","chr16",50139863,649,"Macaque",1,50140512
"chr13:101726049:<DEL>:777:42553.54","<DEL>","chr13",101726049,777,"Macaque",1,101726826
"chr7:8120060:<DEL>:1004:24010.01","<DEL>","chr7",8120060,1004,"Macaque",1,8121064
"chr13:20049726:<DEL>:1600:20088.88","<DEL>","chr13",20049726,1600,"Macaque",1,20051326
"chr20:69933399:<DEL>:40142:6739.45","<DEL>","chr20",69933399,40142,"Macaque",1,69973541
"chr5:854763:<DEL>:446:41299.36","<DEL>","chr5",854763,446,"Macaque",1,855209
"chr1:40094448:<DEL>:1066:46588.4","<DEL>","chr1",40094448,1066,"Macaque",1,40095514
"chr10:79574134:<DEL>:1577:71942.84","<DEL>","chr10",79574134,1577,"Macaque",1,79575711
"chr2:62259734:<DEL>:496:23111.46","<DEL>","chr2",62259734,496,"Macaque",1,62260230
"chr6:139337628:<DEL>:9291:38378.97","<DEL>","chr6",139337628,9291,"Macaque",1,139346919
"chr7:56285445:<DEL>:1406:19100.98","<DEL>","chr7",56285445,1406,"Macaque",1,56286851
"chr3:165408445:<DEL>:1337:8679.49","<DEL>","chr3",165408445,1337,"Macaque",1,165409782
"chr16:40192063:<DEL>:1641:20029.79","<DEL>","chr16",40192063,1641,"Macaque",1,40193704
"chr7:167314099:<DEL>:11859:8633.78","<DEL>","chr7",167314099,11859,"Macaque",1,167325958
"chr8:29590731:<DEL>:1793:9823.63","<DEL>","chr8",29590731,1793,"Macaque",1,29592524
"chr16:76666425:<DEL>:2673:18770.39","<DEL>","chr16",76666425,2673,"Macaque",1,76669098
"chr9:93426707:<DEL>:846:55273.9","<DEL>","chr9",93426707,846,"Macaque",1,93427553
"chr2:99842115:<DEL>:304:34372.8","<DEL>","chr2",99842115,304,"Macaque",1,99842419
"chr7:108091679:<DEL>:45849:23552.4","<DEL>","chr7",108091679,45849,"Macaque",1,108137528
"chr4:38104873:<DEL>:462:33126.95","<DEL>","chr4",38104873,462,"Macaque",1,38105335
"chr8:79178056:<DEL>:641:26112.44","<DEL>","chr8",79178056,641,"Macaque",1,79178697
"chr6:130384:<DEL>:573:10605.49","<DEL>","chr6",130384,573,"Macaque",1,130957
"chr14:9247944:<DEL>:4709:27286.47","<DEL>","chr14",9247944,4709,"Macaque",1,9252653
"chr5:188984674:<DUP>:857:9792.09","<DUP>","chr5",188984674,857,"Macaque",1,188985531
"chr5:36907274:<DEL>:391:24930.4","<DEL>","chr5",36907274,391,"Macaque",1,36907665
"chr1:41084703:<DEL>:864:19544.83","<DEL>","chr1",41084703,864,"Macaque",1,41085567
"chr20:954973:<DEL>:678:14123.24","<DEL>","chr20",954973,678,"Macaque",1,955651
"chr6:27557406:<DEL>:866:7177.43","<DEL>","chr6",27557406,866,"Macaque",1,27558272
"chr1:449149:<DEL>:1375:23338.55","<DEL>","chr1",449149,1375,"Macaque",1,450524
"chr15:67700618:<DEL>:1194:43572.21","<DEL>","chr15",67700618,1194,"Macaque",1,67701812
"chr2:202487487:<DEL>:3576:18841.17","<DEL>","chr2",202487487,3576,"Macaque",1,202491063
"chr20:50680777:<DEL>:588:61486.88","<DEL>","chr20",50680777,588,"Macaque",1,50681365
"chr13:56685589:<DEL>:20415:22186.35","<DEL>","chr13",56685589,20415,"Macaque",1,56706004
"chr10:2697695:<DUP>:559:12224.26","<DUP>","chr10",2697695,559,"Macaque",1,2698254
"chr14:863417:<DUP>:608:8217.62","<DUP>","chr14",863417,608,"Macaque",1,864025
"chr15:17556204:<DEL>:1852:36368.29","<DEL>","chr15",17556204,1852,"Macaque",1,17558056
"chr7:5574837:<DEL>:2806:52319.64","<DEL>","chr7",5574837,2806,"Macaque",1,5577643
"chr9:79213354:<DEL>:850:8338.67","<DEL>","chr9",79213354,850,"Macaque",1,79214204
"chr16:44289615:<DEL>:513:44256.89","<DEL>","chr16",44289615,513,"Macaque",1,44290128
"chr6:12594658:<DEL>:797:36471.63","<DEL>","chr6",12594658,797,"Macaque",1,12595455
"chr8:2689458:<DEL>:1372:9877.78","<DEL>","chr8",2689458,1372,"Macaque",1,2690830
"chr15:17556204:<DEL>:1412:40887.38","<DEL>","chr15",17556204,1412,"Macaque",1,17557616
"chr8:140513982:<DEL>:1294:30221.9","<DEL>","chr8",140513982,1294,"Macaque",1,140515276
"chrX:45763736:<DEL>:535:15282.58","<DEL>","chrX",45763736,535,"Macaque",1,45764271
"chr3:3313946:<DEL>:431:21969.45","<DEL>","chr3",3313946,431,"Macaque",1,3314377
"chr5:37725430:<DEL>:740:24860.68","<DEL>","chr5",37725430,740,"Macaque",1,37726170
"chr12:119701788:<DEL>:507:53173.69","<DEL>","chr12",119701788,507,"Macaque",1,119702295
"chr7:33513286:<DEL>:1628:17518.67","<DEL>","chr7",33513286,1628,"Macaque",1,33514914
"chr16:195181:<DEL>:3258:21241.0","<DEL>","chr16",195181,3258,"Macaque",1,198439
"chr8:72974525:<DEL>:3926:58819.0","<DEL>","chr8",72974525,3926,"Macaque",1,72978451
"chr6:932461:<DEL>:448:57607.73","<DEL>","chr6",932461,448,"Macaque",1,932909
"chr17:57766473:<DEL>:900:42709.96","<DEL>","chr17",57766473,900,"Macaque",1,57767373
"chr15:91357813:<DEL>:545:20556.88","<DEL>","chr15",91357813,545,"Macaque",1,91358358
"chr14:110010800:<DUP>:1201:5703.39","<DUP>","chr14",110010800,1201,"Macaque",1,110012001
"chr3:176012841:<DEL>:3012:25344.42","<DEL>","chr3",176012841,3012,"Macaque",1,176015853
"chr2:197582859:<DEL>:477:43417.05","<DEL>","chr2",197582859,477,"Macaque",1,197583336
"chr16:61992297:<DEL>:729:43209.63","<DEL>","chr16",61992297,729,"Macaque",1,61993026
"chr19:10488902:<DEL>:1523:29690.16","<DEL>","chr19",10488902,1523,"Macaque",1,10490425
"chr13:2691015:<DEL>:737:12716.55","<DEL>","chr13",2691015,737,"Macaque",1,2691752
"chr5:5431099:<DEL>:343:35532.61","<DEL>","chr5",5431099,343,"Macaque",1,5431442
"chr3:1099926:<DEL>:1699:25041.64","<DEL>","chr3",1099926,1699,"Macaque",1,1101625
"chr5:42023758:<DEL>:446:18338.24","<DEL>","chr5",42023758,446,"Macaque",1,42024204
"chr19:38651401:<DUP>:6267:5453.88","<DUP>","chr19",38651401,6267,"Macaque",1,38657668
"chr12:83608544:<DEL>:2901:28672.6","<DEL>","chr12",83608544,2901,"Macaque",1,83611445
"chr17:34149033:<DEL>:825:8887.02","<DEL>","chr17",34149033,825,"Macaque",1,34149858
"chr11:56001085:<DEL>:619:8611.98","<DEL>","chr11",56001085,619,"Macaque",1,56001704
"chr7:163199565:<DEL>:771:29683.61","<DEL>","chr7",163199565,771,"Macaque",1,163200336
"chr6:932054:<DEL>:850:41024.41","<DEL>","chr6",932054,850,"Macaque",1,932904
"chr10:90301260:<DUP>:399:5483.59","<DUP>","chr10",90301260,399,"Macaque",1,90301659
"chr12:115013655:<DEL>:369:38583.99","<DEL>","chr12",115013655,369,"Macaque",1,115014024
"chr10:28904947:<DEL>:665:13963.78","<DEL>","chr10",28904947,665,"Macaque",1,28905612
"chr7:43600819:<DEL>:1015:29424.26","<DEL>","chr7",43600819,1015,"Macaque",1,43601834
"chr2:37897398:<DEL>:1470:41619.13","<DEL>","chr2",37897398,1470,"Macaque",1,37898868
"chr8:78446770:<DEL>:669:25826.08","<DEL>","chr8",78446770,669,"Macaque",1,78447439
"chr9:56527434:<DEL>:429:17180.38","<DEL>","chr9",56527434,429,"Macaque",1,56527863
"chrX:2825129:<DEL>:653:22895.46","<DEL>","chrX",2825129,653,"Macaque",1,2825782
"chr14:118940938:<DEL>:501:15215.63","<DEL>","chr14",118940938,501,"Macaque",1,118941439
"chr9:27198202:<DEL>:2528:46889.24","<DEL>","chr9",27198202,2528,"Macaque",1,27200730
"chr16:77061902:<DEL>:2138:9358.86","<DEL>","chr16",77061902,2138,"Macaque",1,77064040
"chr10:29584774:<DEL>:2114:56218.78","<DEL>","chr10",29584774,2114,"Macaque",1,29586888
"chr9:3099766:<DEL>:1009:6314.25","<DEL>","chr9",3099766,1009,"Macaque",1,3100775
"chr16:67159677:<DEL>:1615:40307.29","<DEL>","chr16",67159677,1615,"Macaque",1,67161292
"chr14:116722159:<DEL>:49093:61034.62","<DEL>","chr14",116722159,49093,"Macaque",1,116771252
"chr4:32258961:<DEL>:92935:20805.09","<DEL>","chr4",32258961,92935,"Macaque",1,32351896
"chr16:49746363:<DEL>:2866:29424.29","<DEL>","chr16",49746363,2866,"Macaque",1,49749229
"chr6:28531301:<DEL>:525:55387.37","<DEL>","chr6",28531301,525,"Macaque",1,28531826
"chr6:83632042:<DEL>:1428:49656.72","<DEL>","chr6",83632042,1428,"Macaque",1,83633470
"chr19:50574329:<DEL>:1005:49690.35","<DEL>","chr19",50574329,1005,"Macaque",1,50575334
"chr12:47109205:<DEL>:877:15867.32","<DEL>","chr12",47109205,877,"Macaque",1,47110082
"chr11:33848352:<DEL>:796:45524.87","<DEL>","chr11",33848352,796,"Macaque",1,33849148
"chr11:117655289:<DEL>:640:14564.0","<DEL>","chr11",117655289,640,"Macaque",1,117655929
"chr4:145911506:<DEL>:985:12673.85","<DEL>","chr4",145911506,985,"Macaque",1,145912491
"chr12:123238203:<DEL>:1848:12306.01","<DEL>","chr12",123238203,1848,"Macaque",1,123240051
"chr19:17716742:<DEL>:5539:13044.29","<DEL>","chr19",17716742,5539,"Macaque",1,17722281
"chr6:145426160:<DEL>:1235:17459.65","<DEL>","chr6",145426160,1235,"Macaque",1,145427395
"chr20:48723979:<DEL>:52866:32238.24","<DEL>","chr20",48723979,52866,"Macaque",1,48776845
"chr12:116005195:<DUP>:517:5551.53","<DUP>","chr12",116005195,517,"Macaque",1,116005712
"chr14:2222671:<DEL>:811:47770.08","<DEL>","chr14",2222671,811,"Macaque",1,2223482
"chr4:30776930:<DEL>:5529:35035.79","<DEL>","chr4",30776930,5529,"Macaque",1,30782459
"chr2:31457224:<DEL>:2027:33442.03","<DEL>","chr2",31457224,2027,"Macaque",1,31459251
"chr7:112547427:<DEL>:596:17087.91","<DEL>","chr7",112547427,596,"Macaque",1,112548023
"chr7:70413430:<DEL>:1217:27025.83","<DEL>","chr7",70413430,1217,"Macaque",1,70414647
"chr3:124275221:<DEL>:684:17576.45","<DEL>","chr3",124275221,684,"Macaque",1,124275905
"chr2:132248561:<DUP>:3521:34032.51","<DUP>","chr2",132248561,3521,"Macaque",1,132252082
"chr6:8099361:<DEL>:31094:34366.95","<DEL>","chr6",8099361,31094,"Macaque",1,8130455
"chr14:4590208:<DEL>:6076:43575.05","<DEL>","chr14",4590208,6076,"Macaque",1,4596284
"chr8:272693:<DEL>:1741:14602.7","<DEL>","chr8",272693,1741,"Macaque",1,274434
"chr15:3073267:<DUP>:422:93126.8","<DUP>","chr15",3073267,422,"Macaque",1,3073689
"chr3:47382731:<DEL>:584:21425.42","<DEL>","chr3",47382731,584,"Macaque",1,47383315
"chr1:91421683:<DEL>:7625:44409.02","<DEL>","chr1",91421683,7625,"Macaque",1,91429308
"chr2:202958802:<DEL>:2739:11079.8","<DEL>","chr2",202958802,2739,"Macaque",1,202961541
"chr18:67250858:<DEL>:1046:7084.46","<DEL>","chr18",67250858,1046,"Macaque",1,67251904
"chr7:74356871:<DEL>:38570:19970.71","<DEL>","chr7",74356871,38570,"Macaque",1,74395441
"chr5:87386690:<DEL>:1394:46942.93","<DEL>","chr5",87386690,1394,"Macaque",1,87388084
"chr3:17417612:<DEL>:354:31328.66","<DEL>","chr3",17417612,354,"Macaque",1,17417966
"chr4:119756876:<DEL>:537:47999.34","<DEL>","chr4",119756876,537,"Macaque",1,119757413
"chr2:77396699:<DEL>:1178:44640.52","<DEL>","chr2",77396699,1178,"Macaque",1,77397877
"chr3:2413379:<DEL>:370:11331.5","<DEL>","chr3",2413379,370,"Macaque",1,2413749
"chr3:8994311:<DUP>:1607:17034.91","<DUP>","chr3",8994311,1607,"Macaque",1,8995918
"chr9:99410756:<DEL>:477:45317.18","<DEL>","chr9",99410756,477,"Macaque",1,99411233
"chrX:128835636:<DEL>:1118:34860.06","<DEL>","chrX",128835636,1118,"Macaque",1,128836754
"chr12:76708114:<DEL>:795:15783.82","<DEL>","chr12",76708114,795,"Macaque",1,76708909
"chr12:92745423:<DEL>:761:18369.03","<DEL>","chr12",92745423,761,"Macaque",1,92746184
"chr15:443222:<DEL>:636:15095.39","<DEL>","chr15",443222,636,"Macaque",1,443858
"chr15:10300445:<DEL>:1681:8579.76","<DEL>","chr15",10300445,1681,"Macaque",1,10302126
"chr6:1478709:<DEL>:1352:20975.18","<DEL>","chr6",1478709,1352,"Macaque",1,1480061
"chr7:126216210:<DEL>:2070:15519.48","<DEL>","chr7",126216210,2070,"Macaque",1,126218280
"chr19:4806508:<DEL>:734:46455.88","<DEL>","chr19",4806508,734,"Macaque",1,4807242
"chr19:148317:<DEL>:775:9591.09","<DEL>","chr19",148317,775,"Macaque",1,149092
"chr9:61842896:<DEL>:56204:31962.86","<DEL>","chr9",61842896,56204,"Macaque",1,61899100
"chr15:7285038:<DEL>:722:65495.58","<DEL>","chr15",7285038,722,"Macaque",1,7285760
"chr10:61323362:<DUP>:424:9193.13","<DUP>","chr10",61323362,424,"Macaque",1,61323786
"chr11:120247866:<DEL>:889:14050.69","<DEL>","chr11",120247866,889,"Macaque",1,120248755
"chr2:14317705:<DEL>:1091:7813.84","<DEL>","chr2",14317705,1091,"Macaque",1,14318796
"chr19:45040234:<DEL>:11773:41093.51","<DEL>","chr19",45040234,11773,"Macaque",1,45052007
"chr1:181001995:<DEL>:627:30907.78","<DEL>","chr1",181001995,627,"Macaque",1,181002622
"chr4:152523655:<DEL>:9129:36543.99","<DEL>","chr4",152523655,9129,"Macaque",1,152532784
"chr3:42674127:<DEL>:899:18881.67","<DEL>","chr3",42674127,899,"Macaque",1,42675026
"chr7:121485535:<DEL>:401:27327.99","<DEL>","chr7",121485535,401,"Macaque",1,121485936
"chr14:125236240:<DEL>:1992:35953.11","<DEL>","chr14",125236240,1992,"Macaque",1,125238232
"chr2:108529121:<DUP>:1110:11103.52","<DUP>","chr2",108529121,1110,"Macaque",1,108530231
"chr6:169793571:<DEL>:1134:26913.14","<DEL>","chr6",169793571,1134,"Macaque",1,169794705
"chr8:143054809:<DEL>:3064:24307.03","<DEL>","chr8",143054809,3064,"Macaque",1,143057873
"chr20:952989:<DEL>:1257:69336.06","<DEL>","chr20",952989,1257,"Macaque",1,954246
"chr5:24494039:<DEL>:1033:16889.72","<DEL>","chr5",24494039,1033,"Macaque",1,24495072
"chr10:88115128:<DEL>:592:56382.27","<DEL>","chr10",88115128,592,"Macaque",1,88115720
"chr3:56921327:<DEL>:387:28555.49","<DEL>","chr3",56921327,387,"Macaque",1,56921714
"chr6:101815138:<DEL>:1001:31789.29","<DEL>","chr6",101815138,1001,"Macaque",1,101816139
"chr9:105277623:<DEL>:2312:51640.14","<DEL>","chr9",105277623,2312,"Macaque",1,105279935
"chr5:98033308:<DEL>:2498:16222.06","<DEL>","chr5",98033308,2498,"Macaque",1,98035806
"chr6:120153296:<DEL>:2717:38265.5","<DEL>","chr6",120153296,2717,"Macaque",1,120156013
"chr9:98512647:<DEL>:3725:14420.9","<DEL>","chr9",98512647,3725,"Macaque",1,98516372
"chr10:40931279:<DEL>:1144:66381.82","<DEL>","chr10",40931279,1144,"Macaque",1,40932423
"chr3:184760985:<DEL>:873:69863.83","<DEL>","chr3",184760985,873,"Macaque",1,184761858
"chr2:202599760:<DEL>:533:32474.07","<DEL>","chr2",202599760,533,"Macaque",1,202600293
"chr17:53054630:<DEL>:1086:26602.29","<DEL>","chr17",53054630,1086,"Macaque",1,53055716
"chr19:12910633:<DEL>:10211:25979.91","<DEL>","chr19",12910633,10211,"Macaque",1,12920844
"chr11:39187996:<DEL>:809:46588.39","<DEL>","chr11",39187996,809,"Macaque",1,39188805
"chr1:37258599:<DEL>:1012:28495.38","<DEL>","chr1",37258599,1012,"Macaque",1,37259611
"chr10:15252188:<DEL>:683:30861.98","<DEL>","chr10",15252188,683,"Macaque",1,15252871
"chr3:2653284:<DEL>:2025:61743.66","<DEL>","chr3",2653284,2025,"Macaque",1,2655309
"chr18:42127727:<DEL>:865:14025.2","<DEL>","chr18",42127727,865,"Macaque",1,42128592
"chr17:41987235:<DEL>:2025:10370.89","<DEL>","chr17",41987235,2025,"Macaque",1,41989260
"chr18:37052610:<DEL>:605:41327.22","<DEL>","chr18",37052610,605,"Macaque",1,37053215
"chr9:127528096:<DEL>:958:31808.26","<DEL>","chr9",127528096,958,"Macaque",1,127529054
"chr2:167080993:<DEL>:1006:69424.69","<DEL>","chr2",167080993,1006,"Macaque",1,167081999
"chr1:12462778:<DEL>:958:38802.51","<DEL>","chr1",12462778,958,"Macaque",1,12463736
"chr3:34287164:<DUP>:520:9483.89","<DUP>","chr3",34287164,520,"Macaque",1,34287684
"chr5:18717474:<DEL>:810:25777.99","<DEL>","chr5",18717474,810,"Macaque",1,18718284
"chr9:82475256:<DEL>:1127:51758.34","<DEL>","chr9",82475256,1127,"Macaque",1,82476383
"chr2:202975780:<DEL>:320:57979.56","<DEL>","chr2",202975780,320,"Macaque",1,202976100
"chr10:81180585:<DEL>:2791:27499.91","<DEL>","chr10",81180585,2791,"Macaque",1,81183376
"chr6:87012249:<DEL>:474:40029.98","<DEL>","chr6",87012249,474,"Macaque",1,87012723
"chr6:43932266:<DEL>:12463:11244.57","<DEL>","chr6",43932266,12463,"Macaque",1,43944729
"chr11:83995875:<DEL>:1111:51551.52","<DEL>","chr11",83995875,1111,"Macaque",1,83996986
"chr2:64445696:<DEL>:1210:39128.07","<DEL>","chr2",64445696,1210,"Macaque",1,64446906
"chr1:85455141:<DEL>:638:11566.31","<DEL>","chr1",85455141,638,"Macaque",1,85455779
"chr11:11981206:<DEL>:62624:26134.83","<DEL>","chr11",11981206,62624,"Macaque",1,12043830
"chr6:33714810:<DEL>:546:21846.43","<DEL>","chr6",33714810,546,"Macaque",1,33715356
"chr17:48633293:<DEL>:1214:17773.35","<DEL>","chr17",48633293,1214,"Macaque",1,48634507
"chr1:89850645:<DEL>:515:17307.83","<DEL>","chr1",89850645,515,"Macaque",1,89851160
"chr4:149895540:<DEL>:1726:44874.93","<DEL>","chr4",149895540,1726,"Macaque",1,149897266
"chr12:1105174:<DEL>:943:24018.0","<DEL>","chr12",1105174,943,"Macaque",1,1106117
"chr15:1397009:<DUP>:504:3603.81","<DUP>","chr15",1397009,504,"Macaque",1,1397513
"chr3:3853264:<DEL>:648:35494.23","<DEL>","chr3",3853264,648,"Macaque",1,3853912
"chr6:65685630:<DEL>:329:25802.61","<DEL>","chr6",65685630,329,"Macaque",1,65685959
"chr19:49561641:<DUP>:44893:3374.07","<DUP>","chr19",49561641,44893,"Macaque",1,49606534
"chr14:21733940:<DEL>:569:34506.79","<DEL>","chr14",21733940,569,"Macaque",1,21734509
"chr10:91885178:<DEL>:1470:45318.06","<DEL>","chr10",91885178,1470,"Macaque",1,91886648
"chr6:46559707:<DEL>:1047:55923.81","<DEL>","chr6",46559707,1047,"Macaque",1,46560754
"chr6:27594620:<DEL>:509:14915.34","<DEL>","chr6",27594620,509,"Macaque",1,27595129
"chr16:16991935:<DEL>:1178:11647.22","<DEL>","chr16",16991935,1178,"Macaque",1,16993113
"chr17:20344773:<DEL>:850:11019.66","<DEL>","chr17",20344773,850,"Macaque",1,20345623
"chr17:20105312:<DEL>:3909:20675.78","<DEL>","chr17",20105312,3909,"Macaque",1,20109221
"chr6:43736599:<DUP>:3818:8162.89","<DUP>","chr6",43736599,3818,"Macaque",1,43740417
"chr15:1197263:<DEL>:957:17308.93","<DEL>","chr15",1197263,957,"Macaque",1,1198220
"chr5:3698080:<DEL>:802:12214.67","<DEL>","chr5",3698080,802,"Macaque",1,3698882
"chr20:69263835:<DEL>:928:25957.56","<DEL>","chr20",69263835,928,"Macaque",1,69264763
"chrX:22692689:<DEL>:570:35066.86","<DEL>","chrX",22692689,570,"Macaque",1,22693259
"chr3:4240673:<DEL>:486:53631.05","<DEL>","chr3",4240673,486,"Macaque",1,4241159
"chr2:201266862:<DEL>:1673:48301.89","<DEL>","chr2",201266862,1673,"Macaque",1,201268535
"chrX:24455256:<DEL>:525:33275.63","<DEL>","chrX",24455256,525,"Macaque",1,24455781
"chr19:42822095:<DEL>:676:43033.29","<DEL>","chr19",42822095,676,"Macaque",1,42822771
"chr6:125422192:<DEL>:335:19523.44","<DEL>","chr6",125422192,335,"Macaque",1,125422527
"chr13:44939475:<DEL>:1156:11446.46","<DEL>","chr13",44939475,1156,"Macaque",1,44940631
"chr17:41552315:<DEL>:6207:40660.39","<DEL>","chr17",41552315,6207,"Macaque",1,41558522
"chr14:127169602:<DEL>:447:15867.11","<DEL>","chr14",127169602,447,"Macaque",1,127170049
"chr19:3318356:<DEL>:652:40956.04","<DEL>","chr19",3318356,652,"Macaque",1,3319008
"chr15:105538808:<DEL>:1016:51256.1","<DEL>","chr15",105538808,1016,"Macaque",1,105539824
"chr7:5102758:<DEL>:46210:21319.67","<DEL>","chr7",5102758,46210,"Macaque",1,5148968
"chr19:12968839:<DEL>:1978:36043.76","<DEL>","chr19",12968839,1978,"Macaque",1,12970817
"chr7:151172236:<DEL>:2052:28478.91","<DEL>","chr7",151172236,2052,"Macaque",1,151174288
"chr10:61865578:<DEL>:503:37971.54","<DEL>","chr10",61865578,503,"Macaque",1,61866081
"chr3:97053643:<DEL>:402:16217.15","<DEL>","chr3",97053643,402,"Macaque",1,97054045
"chr1:8580918:<DUP>:339:32505.88","<DUP>","chr1",8580918,339,"Macaque",1,8581257
"chr19:3451924:<DEL>:1886:37016.65","<DEL>","chr19",3451924,1886,"Macaque",1,3453810
"chr13:63290290:<DEL>:778:16387.26","<DEL>","chr13",63290290,778,"Macaque",1,63291068
"chr8:25773295:<DEL>:732:17238.81","<DEL>","chr8",25773295,732,"Macaque",1,25774027
"chr2:96894953:<DEL>:1574:12417.22","<DEL>","chr2",96894953,1574,"Macaque",1,96896527
"chr1:110828189:<DEL>:474:22595.45","<DEL>","chr1",110828189,474,"Macaque",1,110828663
"chr7:79046900:<DEL>:1045:56254.99","<DEL>","chr7",79046900,1045,"Macaque",1,79047945
"chr9:9001939:<DEL>:614:7205.25","<DEL>","chr9",9001939,614,"Macaque",1,9002553
"chr13:31809164:<DEL>:2731:35805.42","<DEL>","chr13",31809164,2731,"Macaque",1,31811895
"chr15:67376000:<DEL>:333:44070.86","<DEL>","chr15",67376000,333,"Macaque",1,67376333
"chr8:9212854:<DEL>:1244:45347.61","<DEL>","chr8",9212854,1244,"Macaque",1,9214098
"chr3:105926842:<DEL>:2452:46854.26","<DEL>","chr3",105926842,2452,"Macaque",1,105929294
"chr10:6516166:<DEL>:763:37008.85","<DEL>","chr10",6516166,763,"Macaque",1,6516929
"chr1:193621724:<DEL>:901:12277.94","<DEL>","chr1",193621724,901,"Macaque",1,193622625
"chr15:69632067:<DEL>:697:45258.96","<DEL>","chr15",69632067,697,"Macaque",1,69632764
"chr8:98170534:<DEL>:618:9874.72","<DEL>","chr8",98170534,618,"Macaque",1,98171152
"chr12:57741586:<DEL>:401:16643.84","<DEL>","chr12",57741586,401,"Macaque",1,57741987
"chr8:141421182:<DEL>:1826:76455.79","<DEL>","chr8",141421182,1826,"Macaque",1,141423008
"chr9:117590142:<DEL>:1221:22068.22","<DEL>","chr9",117590142,1221,"Macaque",1,117591363
"chr7:144877331:<DEL>:365:24267.59","<DEL>","chr7",144877331,365,"Macaque",1,144877696
"chr3:5859820:<DEL>:1334:16106.36","<DEL>","chr3",5859820,1334,"Macaque",1,5861154
"chr8:21677126:<DEL>:1708:53294.52","<DEL>","chr8",21677126,1708,"Macaque",1,21678834
"chrX:1107401:<DEL>:876:12083.51","<DEL>","chrX",1107401,876,"Macaque",1,1108277
"chr8:54393608:<DEL>:446:45908.93","<DEL>","chr8",54393608,446,"Macaque",1,54394054
"chr16:75536049:<DEL>:1823:36721.21","<DEL>","chr16",75536049,1823,"Macaque",1,75537872
"chr20:53947555:<DEL>:601:36390.12","<DEL>","chr20",53947555,601,"Macaque",1,53948156
"chr15:34100321:<DEL>:2804:28869.26","<DEL>","chr15",34100321,2804,"Macaque",1,34103125
"chr1:15005411:<DEL>:622:14763.51","<DEL>","chr1",15005411,622,"Macaque",1,15006033
"chr5:27105458:<DEL>:431:48410.05","<DEL>","chr5",27105458,431,"Macaque",1,27105889
"chr3:49784015:<DEL>:1636:16939.92","<DEL>","chr3",49784015,1636,"Macaque",1,49785651
"chr7:37719621:<DEL>:1127:25557.12","<DEL>","chr7",37719621,1127,"Macaque",1,37720748
"chr11:11806051:<DEL>:407:15694.8","<DEL>","chr11",11806051,407,"Macaque",1,11806458
"chr15:55191774:<DEL>:961:11316.49","<DEL>","chr15",55191774,961,"Macaque",1,55192735
"chr4:170096656:<DEL>:692:33159.44","<DEL>","chr4",170096656,692,"Macaque",1,170097348
"chr11:85658999:<DEL>:1282:17781.58","<DEL>","chr11",85658999,1282,"Macaque",1,85660281
"chr10:37780305:<DEL>:298:25012.31","<DEL>","chr10",37780305,298,"Macaque",1,37780603
"chr13:2040168:<DEL>:692:5249.66","<DEL>","chr13",2040168,692,"Macaque",1,2040860
"chr4:69721967:<DEL>:990:17703.13","<DEL>","chr4",69721967,990,"Macaque",1,69722957
"chr15:90637340:<DEL>:773:17710.68","<DEL>","chr15",90637340,773,"Macaque",1,90638113
"chr6:127526353:<DEL>:431:31147.25","<DEL>","chr6",127526353,431,"Macaque",1,127526784
"chr20:41837658:<DEL>:553:25281.99","<DEL>","chr20",41837658,553,"Macaque",1,41838211
"chr6:153873000:<DEL>:39811:41129.75","<DEL>","chr6",153873000,39811,"Macaque",1,153912811
"chr4:50333132:<DEL>:450:13652.33","<DEL>","chr4",50333132,450,"Macaque",1,50333582
"chr18:8968264:<DEL>:608:33857.45","<DEL>","chr18",8968264,608,"Macaque",1,8968872
"chr2:181256054:<DEL>:508:30294.65","<DEL>","chr2",181256054,508,"Macaque",1,181256562
"chr13:1878477:<DEL>:921:51498.87","<DEL>","chr13",1878477,921,"Macaque",1,1879398
"chr3:34074551:<DEL>:730:25551.83","<DEL>","chr3",34074551,730,"Macaque",1,34075281
"chr7:163208978:<DEL>:491:10341.34","<DEL>","chr7",163208978,491,"Macaque",1,163209469
"chr20:39886538:<DEL>:96624:14731.88","<DEL>","chr20",39886538,96624,"Macaque",1,39983162
"chr7:167215158:<DEL>:1113:23192.47","<DEL>","chr7",167215158,1113,"Macaque",1,167216271
"chrX:12508428:<DUP>:20039:5571.36","<DUP>","chrX",12508428,20039,"Macaque",1,12528467
"chr1:98295687:<DEL>:1045:16018.47","<DEL>","chr1",98295687,1045,"Macaque",1,98296732
"chr14:11901152:<DEL>:672:60126.59","<DEL>","chr14",11901152,672,"Macaque",1,11901824
"chr5:74068358:<DEL>:582:14758.26","<DEL>","chr5",74068358,582,"Macaque",1,74068940
"chr9:129414842:<DEL>:403:65760.15","<DEL>","chr9",129414842,403,"Macaque",1,129415245
"chr9:124587176:<DEL>:45071:33606.09","<DEL>","chr9",124587176,45071,"Macaque",1,124632247
"chr5:106282220:<DEL>:1402:8836.91","<DEL>","chr5",106282220,1402,"Macaque",1,106283622
"chr7:165279167:<DEL>:714:14001.56","<DEL>","chr7",165279167,714,"Macaque",1,165279881
"chr10:88252742:<DEL>:1574:54358.05","<DEL>","chr10",88252742,1574,"Macaque",1,88254316
"chr15:11103879:<DEL>:697:34197.02","<DEL>","chr15",11103879,697,"Macaque",1,11104576
"chr20:33457623:<DEL>:40435:20521.25","<DEL>","chr20",33457623,40435,"Macaque",1,33498058
"chr8:88999106:<DEL>:501:28056.43","<DEL>","chr8",88999106,501,"Macaque",1,88999607
"chr3:2266361:<DEL>:775:6169.39","<DEL>","chr3",2266361,775,"Macaque",1,2267136
"chr9:8620580:<DEL>:562:31717.68","<DEL>","chr9",8620580,562,"Macaque",1,8621142
"chr10:12151604:<DEL>:815:69601.96","<DEL>","chr10",12151604,815,"Macaque",1,12152419
"chr6:176536500:<DEL>:3437:37763.4","<DEL>","chr6",176536500,3437,"Macaque",1,176539937
"chr19:45939416:<DEL>:411:62801.9","<DEL>","chr19",45939416,411,"Macaque",1,45939827
"chr19:16617261:<DEL>:1281:12733.34","<DEL>","chr19",16617261,1281,"Macaque",1,16618542
"chr2:50297948:<DEL>:464:51567.52","<DEL>","chr2",50297948,464,"Macaque",1,50298412
"chr7:136333647:<DEL>:753:14109.25","<DEL>","chr7",136333647,753,"Macaque",1,136334400
"chr15:95439727:<DEL>:1375:26815.1","<DEL>","chr15",95439727,1375,"Macaque",1,95441102
"chr4:67672337:<DEL>:409:14941.19","<DEL>","chr4",67672337,409,"Macaque",1,67672746
"chr3:14175976:<DEL>:411:14101.79","<DEL>","chr3",14175976,411,"Macaque",1,14176387
"chr3:3356975:<DEL>:999:35775.86","<DEL>","chr3",3356975,999,"Macaque",1,3357974
"chr14:121310621:<DEL>:509:61358.71","<DEL>","chr14",121310621,509,"Macaque",1,121311130
"chr2:203058704:<DEL>:950:56426.05","<DEL>","chr2",203058704,950,"Macaque",1,203059654
"chr8:29923378:<DEL>:328:29725.59","<DEL>","chr8",29923378,328,"Macaque",1,29923706
"chr17:22285991:<DEL>:319:38602.81","<DEL>","chr17",22285991,319,"Macaque",1,22286310
"chr2:201778129:<DUP>:626:8122.94","<DUP>","chr2",201778129,626,"Macaque",1,201778755
"chr3:35465633:<DEL>:3900:34091.96","<DEL>","chr3",35465633,3900,"Macaque",1,35469533
"chr2:37512855:<DEL>:5233:20471.62","<DEL>","chr2",37512855,5233,"Macaque",1,37518088
"chr18:62008285:<DEL>:40793:12083.29","<DEL>","chr18",62008285,40793,"Macaque",1,62049078
"chr7:78920373:<DEL>:677:22854.54","<DEL>","chr7",78920373,677,"Macaque",1,78921050
"chr1:114066388:<DEL>:1341:37329.25","<DEL>","chr1",114066388,1341,"Macaque",1,114067729
"chr12:56283952:<DEL>:526:12258.01","<DEL>","chr12",56283952,526,"Macaque",1,56284478
"chr13:62219348:<DEL>:921:17578.1","<DEL>","chr13",62219348,921,"Macaque",1,62220269
"chr2:179642613:<DEL>:1391:28153.95","<DEL>","chr2",179642613,1391,"Macaque",1,179644004
"chr10:2965906:<DEL>:883:80857.64","<DEL>","chr10",2965906,883,"Macaque",1,2966789
"chrX:30175904:<DEL>:1511:28803.89","<DEL>","chrX",30175904,1511,"Macaque",1,30177415
"chr7:58021509:<DEL>:2872:15000.53","<DEL>","chr7",58021509,2872,"Macaque",1,58024381
"chr4:160210078:<DEL>:784:21032.31","<DEL>","chr4",160210078,784,"Macaque",1,160210862
"chr4:4317589:<DEL>:1649:28659.67","<DEL>","chr4",4317589,1649,"Macaque",1,4319238
"chr6:167227185:<DEL>:503:26688.87","<DEL>","chr6",167227185,503,"Macaque",1,167227688
"chr9:48634965:<DEL>:1095:39171.59","<DEL>","chr9",48634965,1095,"Macaque",1,48636060
"chr13:91627391:<DEL>:2542:33264.78","<DEL>","chr13",91627391,2542,"Macaque",1,91629933
"chr3:2823907:<DUP>:302:9711.31","<DUP>","chr3",2823907,302,"Macaque",1,2824209
"chr12:122308353:<DEL>:1223:45905.64","<DEL>","chr12",122308353,1223,"Macaque",1,122309576
"chr16:16671323:<DEL>:552:13241.03","<DEL>","chr16",16671323,552,"Macaque",1,16671875
"chr7:168561511:<DEL>:9690:37798.3","<DEL>","chr7",168561511,9690,"Macaque",1,168571201
"chr9:110649256:<DEL>:1263:8200.26","<DEL>","chr9",110649256,1263,"Macaque",1,110650519
"chr18:37601212:<DUP>:549:9341.77","<DUP>","chr18",37601212,549,"Macaque",1,37601761
"chr4:2576261:<DEL>:583:17455.06","<DEL>","chr4",2576261,583,"Macaque",1,2576844
"chr4:71907498:<DEL>:1099:29091.32","<DEL>","chr4",71907498,1099,"Macaque",1,71908597
"chr10:90842182:<DEL>:1711:17961.92","<DEL>","chr10",90842182,1711,"Macaque",1,90843893
"chr6:21726719:<DEL>:788:43397.85","<DEL>","chr6",21726719,788,"Macaque",1,21727507
"chr14:92544568:<DEL>:1192:10944.39","<DEL>","chr14",92544568,1192,"Macaque",1,92545760
"chr15:18004171:<DEL>:482:42739.46","<DEL>","chr15",18004171,482,"Macaque",1,18004653
"chr14:15429074:<DEL>:649:35766.98","<DEL>","chr14",15429074,649,"Macaque",1,15429723
"chr7:67806541:<DEL>:842:37902.92","<DEL>","chr7",67806541,842,"Macaque",1,67807383
"chr2:177465586:<DEL>:1569:24442.0","<DEL>","chr2",177465586,1569,"Macaque",1,177467155
"chr10:91343268:<DEL>:2124:9942.12","<DEL>","chr10",91343268,2124,"Macaque",1,91345392
"chr2:76552168:<DEL>:2347:24544.47","<DEL>","chr2",76552168,2347,"Macaque",1,76554515
"chr6:692666:<DEL>:851:6142.81","<DEL>","chr6",692666,851,"Macaque",1,693517
"chr16:8716850:<DEL>:564:17851.83","<DEL>","chr16",8716850,564,"Macaque",1,8717414
"chr11:20631458:<DEL>:7587:28301.64","<DEL>","chr11",20631458,7587,"Macaque",1,20639045
"chr19:36365127:<DEL>:4457:13057.94","<DEL>","chr19",36365127,4457,"Macaque",1,36369584
"chr20:73314305:<DEL>:890:62245.91","<DEL>","chr20",73314305,890,"Macaque",1,73315195
"chr13:2764610:<DEL>:676:14361.53","<DEL>","chr13",2764610,676,"Macaque",1,2765286
"chr9:125237027:<DEL>:1146:17873.2","<DEL>","chr9",125237027,1146,"Macaque",1,125238173
"chr12:125367295:<DEL>:1143:25140.62","<DEL>","chr12",125367295,1143,"Macaque",1,125368438
"chr6:654902:<DEL>:978:10900.71","<DEL>","chr6",654902,978,"Macaque",1,655880
"chr12:110589894:<DEL>:42276:25524.6","<DEL>","chr12",110589894,42276,"Macaque",1,110632170
"chr1:118654484:<DEL>:574:6245.5","<DEL>","chr1",118654484,574,"Macaque",1,118655058
"chr9:44790227:<DEL>:6160:26188.11","<DEL>","chr9",44790227,6160,"Macaque",1,44796387
"chr18:37089974:<DEL>:755:15697.07","<DEL>","chr18",37089974,755,"Macaque",1,37090729
"chr5:168060448:<DEL>:1348:19293.92","<DEL>","chr5",168060448,1348,"Macaque",1,168061796
"chr3:3962300:<DEL>:2757:12664.15","<DEL>","chr3",3962300,2757,"Macaque",1,3965057
"chr12:70257044:<DEL>:3845:61123.29","<DEL>","chr12",70257044,3845,"Macaque",1,70260889
"chr6:683932:<DEL>:59677:24942.04","<DEL>","chr6",683932,59677,"Macaque",1,743609
"chr12:156876:<DEL>:2823:43397.82","<DEL>","chr12",156876,2823,"Macaque",1,159699
"chr15:827398:<DEL>:2012:22599.97","<DEL>","chr15",827398,2012,"Macaque",1,829410
"chr10:22755139:<DEL>:783:52295.49","<DEL>","chr10",22755139,783,"Macaque",1,22755922
"chr15:64957375:<DEL>:412:16350.89","<DEL>","chr15",64957375,412,"Macaque",1,64957787
"chr20:73595074:<DEL>:5501:25908.73","<DEL>","chr20",73595074,5501,"Macaque",1,73600575
"chr3:180012860:<DEL>:841:11802.28","<DEL>","chr3",180012860,841,"Macaque",1,180013701
"chr10:2699824:<DEL>:971:30324.37","<DEL>","chr10",2699824,971,"Macaque",1,2700795
"chr10:35109699:<DEL>:541:15968.12","<DEL>","chr10",35109699,541,"Macaque",1,35110240
"chr10:23578187:<DEL>:726:22287.89","<DEL>","chr10",23578187,726,"Macaque",1,23578913
"chr14:2031702:<DEL>:1144:18670.45","<DEL>","chr14",2031702,1144,"Macaque",1,2032846
"chr1:130767413:<DEL>:1079:26466.18","<DEL>","chr1",130767413,1079,"Macaque",1,130768492
"chr17:93606397:<DUP>:666:4300.67","<DUP>","chr17",93606397,666,"Macaque",1,93607063
"chr9:96428973:<DEL>:21851:14151.4","<DEL>","chr9",96428973,21851,"Macaque",1,96450824
"chr18:60509383:<DEL>:27570:17666.43","<DEL>","chr18",60509383,27570,"Macaque",1,60536953
"chr7:168550443:<DEL>:1548:12998.66","<DEL>","chr7",168550443,1548,"Macaque",1,168551991
"chr10:65475337:<DEL>:1229:18755.65","<DEL>","chr10",65475337,1229,"Macaque",1,65476566
"chr8:29081163:<DEL>:8671:9409.15","<DEL>","chr8",29081163,8671,"Macaque",1,29089834
"chr13:64624270:<DEL>:581:7810.02","<DEL>","chr13",64624270,581,"Macaque",1,64624851
"chr20:1178298:<DEL>:411:74287.41","<DEL>","chr20",1178298,411,"Macaque",1,1178709
"chr7:2143672:<DUP>:1961:4210.91","<DUP>","chr7",2143672,1961,"Macaque",1,2145633
"chr3:40310590:<DEL>:336:28483.53","<DEL>","chr3",40310590,336,"Macaque",1,40310926
"chr6:57634:<DEL>:932:27119.97","<DEL>","chr6",57634,932,"Macaque",1,58566
"chr10:7725769:<DEL>:879:9412.71","<DEL>","chr10",7725769,879,"Macaque",1,7726648
"chr11:131437454:<DEL>:448:21126.93","<DEL>","chr11",131437454,448,"Macaque",1,131437902
"chr10:46250078:<DEL>:513:40881.31","<DEL>","chr10",46250078,513,"Macaque",1,46250591
"chr12:124126719:<DEL>:1058:50015.31","<DEL>","chr12",124126719,1058,"Macaque",1,124127777
"chr2:190895896:<DEL>:2086:19725.07","<DEL>","chr2",190895896,2086,"Macaque",1,190897982
"chr7:67767505:<DUP>:657:41214.78","<DUP>","chr7",67767505,657,"Macaque",1,67768162
"chr7:136066528:<DEL>:314:42326.26","<DEL>","chr7",136066528,314,"Macaque",1,136066842
"chr18:31614831:<DEL>:1080:27592.62","<DEL>","chr18",31614831,1080,"Macaque",1,31615911
"chr19:21103965:<DEL>:954:14508.21","<DEL>","chr19",21103965,954,"Macaque",1,21104919
"chr20:21585100:<DEL>:575:39432.67","<DEL>","chr20",21585100,575,"Macaque",1,21585675
"chr13:11154860:<DEL>:1878:35386.51","<DEL>","chr13",11154860,1878,"Macaque",1,11156738
"chr2:98178259:<DUP>:55620:4950.8","<DUP>","chr2",98178259,55620,"Macaque",1,98233879
"chr6:89420546:<DEL>:1607:14279.11","<DEL>","chr6",89420546,1607,"Macaque",1,89422153
"chr14:109664212:<DEL>:1157:63575.32","<DEL>","chr14",109664212,1157,"Macaque",1,109665369
"chr19:4702342:<DEL>:760:46802.19","<DEL>","chr19",4702342,760,"Macaque",1,4703102
"chr8:78219239:<DEL>:347:24132.14","<DEL>","chr8",78219239,347,"Macaque",1,78219586
"chr11:27281324:<DEL>:507:21114.33","<DEL>","chr11",27281324,507,"Macaque",1,27281831
"chr5:93998711:<DEL>:51760:7491.9","<DEL>","chr5",93998711,51760,"Macaque",1,94050471
"chr13:8551279:<DEL>:367:31994.01","<DEL>","chr13",8551279,367,"Macaque",1,8551646
"chr2:202617546:<DUP>:802:10540.0","<DUP>","chr2",202617546,802,"Macaque",1,202618348
"chr4:129839273:<DEL>:658:7200.03","<DEL>","chr4",129839273,658,"Macaque",1,129839931
"chr13:72765962:<DEL>:785:58966.69","<DEL>","chr13",72765962,785,"Macaque",1,72766747
"chr18:68621683:<DEL>:440:69453.57","<DEL>","chr18",68621683,440,"Macaque",1,68622123
"chr2:187332265:<DEL>:1046:29007.53","<DEL>","chr2",187332265,1046,"Macaque",1,187333311
"chr13:21508255:<DEL>:1097:40404.67","<DEL>","chr13",21508255,1097,"Macaque",1,21509352
"chr13:108492849:<DEL>:42263:43521.79","<DEL>","chr13",108492849,42263,"Macaque",1,108535112
"chr4:125493116:<DEL>:3912:26734.51","<DEL>","chr4",125493116,3912,"Macaque",1,125497028
"chr20:69654794:<DEL>:480:68420.91","<DEL>","chr20",69654794,480,"Macaque",1,69655274
"chr2:204405987:<DUP>:936:9275.44","<DUP>","chr2",204405987,936,"Macaque",1,204406923
"chr19:49714017:<DEL>:2291:41300.31","<DEL>","chr19",49714017,2291,"Macaque",1,49716308
"chr8:13246779:<DEL>:7898:450728.89","<DEL>","chr8",13246779,7898,"Macaque",1,13254677
"chr8:86697713:<DEL>:610:31207.74","<DEL>","chr8",86697713,610,"Macaque",1,86698323
"chr3:173340445:<DEL>:43502:12942.06","<DEL>","chr3",173340445,43502,"Macaque",1,173383947
"chr6:72937579:<DEL>:897:52762.77","<DEL>","chr6",72937579,897,"Macaque",1,72938476
"chr3:169916762:<DEL>:716:19846.21","<DEL>","chr3",169916762,716,"Macaque",1,169917478
"chr6:113056491:<DEL>:47096:45258.99","<DEL>","chr6",113056491,47096,"Macaque",1,113103587
"chr4:159884943:<DEL>:3484:14722.81","<DEL>","chr4",159884943,3484,"Macaque",1,159888427
"chr3:23976095:<DEL>:52608:50251.68","<DEL>","chr3",23976095,52608,"Macaque",1,24028703
"chr11:3138967:<DEL>:1056:18523.16","<DEL>","chr11",3138967,1056,"Macaque",1,3140023
"chr15:28963175:<DEL>:4602:34971.82","<DEL>","chr15",28963175,4602,"Macaque",1,28967777
"chr12:114904928:<DEL>:92497:14982.89","<DEL>","chr12",114904928,92497,"Macaque",1,114997425
"chr9:1107285:<DEL>:618:7151.24","<DEL>","chr9",1107285,618,"Macaque",1,1107903
"chr13:61338104:<DEL>:666:30330.33","<DEL>","chr13",61338104,666,"Macaque",1,61338770
"chr4:168688960:<DUP>:2117:10756.09","<DUP>","chr4",168688960,2117,"Macaque",1,168691077
"chr4:42169972:<DEL>:7241:4445.52","<DEL>","chr4",42169972,7241,"Macaque",1,42177213
"chr1:6712825:<DEL>:1270:10148.27","<DEL>","chr1",6712825,1270,"Macaque",1,6714095
"chr15:43245311:<DEL>:1023:31669.49","<DEL>","chr15",43245311,1023,"Macaque",1,43246334
"chr1:142659225:<DEL>:47570:29480.22","<DEL>","chr1",142659225,47570,"Macaque",1,142706795
"chr2:203337010:<DEL>:933:11701.98","<DEL>","chr2",203337010,933,"Macaque",1,203337943
"chr5:173017066:<DEL>:696:36583.52","<DEL>","chr5",173017066,696,"Macaque",1,173017762
"chr16:53948025:<DEL>:2431:34121.5","<DEL>","chr16",53948025,2431,"Macaque",1,53950456
"chr15:24480210:<DEL>:1788:30436.56","<DEL>","chr15",24480210,1788,"Macaque",1,24481998
"chr18:17608844:<DEL>:336:25730.07","<DEL>","chr18",17608844,336,"Macaque",1,17609180
"chr12:40870279:<DEL>:647:10201.01","<DEL>","chr12",40870279,647,"Macaque",1,40870926
"chr15:41452171:<DEL>:667:51765.18","<DEL>","chr15",41452171,667,"Macaque",1,41452838
"chr7:37848222:<DEL>:1268:37035.53","<DEL>","chr7",37848222,1268,"Macaque",1,37849490
"chr11:132461912:<DUP>:636:9238.48","<DUP>","chr11",132461912,636,"Macaque",1,132462548
"chr16:25073924:<DEL>:854:7372.88","<DEL>","chr16",25073924,854,"Macaque",1,25074778
"chr18:52791644:<DUP>:317:16736.59","<DUP>","chr18",52791644,317,"Macaque",1,52791961
"chr20:73343246:<DEL>:4961:25047.53","<DEL>","chr20",73343246,4961,"Macaque",1,73348207
"chr3:35359302:<DEL>:317:22624.12","<DEL>","chr3",35359302,317,"Macaque",1,35359619
"chr4:87479234:<DEL>:9922:14947.22","<DEL>","chr4",87479234,9922,"Macaque",1,87489156
"chr1:221576262:<DEL>:1073:46949.11","<DEL>","chr1",221576262,1073,"Macaque",1,221577335
"chr20:935453:<DEL>:856:65633.28","<DEL>","chr20",935453,856,"Macaque",1,936309
"chr9:36981712:<DEL>:541:54122.45","<DEL>","chr9",36981712,541,"Macaque",1,36982253
"chr3:116845144:<DEL>:1582:51965.16","<DEL>","chr3",116845144,1582,"Macaque",1,116846726
"chr3:806153:<DEL>:2365:48420.05","<DEL>","chr3",806153,2365,"Macaque",1,808518
"chr13:93676631:<DEL>:2195:72438.02","<DEL>","chr13",93676631,2195,"Macaque",1,93678826
"chr9:90743609:<DEL>:1620:23740.65","<DEL>","chr9",90743609,1620,"Macaque",1,90745229
"chr19:19546788:<DEL>:508:34486.94","<DEL>","chr19",19546788,508,"Macaque",1,19547296
"chr3:124178991:<DEL>:156:4912.45","<DEL>","chr3",124178991,156,"Macaque",1,124179147
"chr5:151313882:<DEL>:2691:39245.48","<DEL>","chr5",151313882,2691,"Macaque",1,151316573
"chr1:187796:<DEL>:864:17033.38","<DEL>","chr1",187796,864,"Macaque",1,188660
"chr10:92158017:<DEL>:2613:29438.72","<DEL>","chr10",92158017,2613,"Macaque",1,92160630
"chr4:54959291:<DUP>:4770:4091.58","<DUP>","chr4",54959291,4770,"Macaque",1,54964061
"chr11:124478552:<DEL>:431:36076.86","<DEL>","chr11",124478552,431,"Macaque",1,124478983
"chr7:95530777:<DEL>:3693:15744.65","<DEL>","chr7",95530777,3693,"Macaque",1,95534470
"chr12:10133782:<DEL>:1143:24618.0","<DEL>","chr12",10133782,1143,"Macaque",1,10134925
"chr4:96467158:<DEL>:2343:20965.04","<DEL>","chr4",96467158,2343,"Macaque",1,96469501
"chr5:141281086:<DEL>:638:56544.18","<DEL>","chr5",141281086,638,"Macaque",1,141281724
"chr9:115658508:<DEL>:930:10531.47","<DEL>","chr9",115658508,930,"Macaque",1,115659438
"chr9:5794525:<DUP>:481:10879.81","<DUP>","chr9",5794525,481,"Macaque",1,5795006
"chr10:318666:<DEL>:2125:39114.15","<DEL>","chr10",318666,2125,"Macaque",1,320791
"chr1:203599555:<DEL>:3893:30388.36","<DEL>","chr1",203599555,3893,"Macaque",1,203603448
"chr9:128944931:<DEL>:948:33302.96","<DEL>","chr9",128944931,948,"Macaque",1,128945879
"chr19:53507605:<DEL>:2721:12513.63","<DEL>","chr19",53507605,2721,"Macaque",1,53510326
"chr1:10105270:<DEL>:876:58730.34","<DEL>","chr1",10105270,876,"Macaque",1,10106146
"chr2:54500338:<DEL>:2640:35185.01","<DEL>","chr2",54500338,2640,"Macaque",1,54502978
"chr8:53476818:<DEL>:478:47946.02","<DEL>","chr8",53476818,478,"Macaque",1,53477296
"chr9:2616834:<DEL>:444:16406.79","<DEL>","chr9",2616834,444,"Macaque",1,2617278
"chr8:108054329:<DEL>:1544:44077.29","<DEL>","chr8",108054329,1544,"Macaque",1,108055873
"chr19:17953013:<DEL>:1233:18427.74","<DEL>","chr19",17953013,1233,"Macaque",1,17954246
"chr1:87280433:<DEL>:711:51787.86","<DEL>","chr1",87280433,711,"Macaque",1,87281144
"chr2:186122241:<DEL>:849:11711.16","<DEL>","chr2",186122241,849,"Macaque",1,186123090
"chr5:39664090:<DEL>:984:54417.16","<DEL>","chr5",39664090,984,"Macaque",1,39665074
"chr5:3711053:<DEL>:5018:19237.59","<DEL>","chr5",3711053,5018,"Macaque",1,3716071
"chr3:174719754:<DEL>:41485:34043.69","<DEL>","chr3",174719754,41485,"Macaque",1,174761239
"chr7:104605043:<DEL>:41335:13670.08","<DEL>","chr7",104605043,41335,"Macaque",1,104646378
"chr1:21088781:<DEL>:1170:28341.24","<DEL>","chr1",21088781,1170,"Macaque",1,21089951
"chr14:119625282:<DEL>:866:32260.33","<DEL>","chr14",119625282,866,"Macaque",1,119626148
"chr19:50995323:<DEL>:300:30254.22","<DEL>","chr19",50995323,300,"Macaque",1,50995623
"chr7:22043784:<DEL>:1113:36455.82","<DEL>","chr7",22043784,1113,"Macaque",1,22044897
"chr1:32208357:<DEL>:53896:42541.12","<DEL>","chr1",32208357,53896,"Macaque",1,32262253
"chr8:24558241:<DEL>:642:9229.2","<DEL>","chr8",24558241,642,"Macaque",1,24558883
"chr1:164536564:<DEL>:1760:31521.76","<DEL>","chr1",164536564,1760,"Macaque",1,164538324
"chr17:78982265:<DEL>:51301:34032.86","<DEL>","chr17",78982265,51301,"Macaque",1,79033566
"chr12:125046411:<DEL>:588:8022.44","<DEL>","chr12",125046411,588,"Macaque",1,125046999
"chr9:44544620:<DEL>:579:34348.1","<DEL>","chr9",44544620,579,"Macaque",1,44545199
"chr6:29594161:<DEL>:1209:113385.3","<DEL>","chr6",29594161,1209,"Macaque",1,29595370
"chr14:92128470:<DEL>:436:17709.35","<DEL>","chr14",92128470,436,"Macaque",1,92128906
"chr5:72247447:<DEL>:1579:6326.74","<DEL>","chr5",72247447,1579,"Macaque",1,72249026
"chr3:182142510:<DEL>:860:10666.92","<DEL>","chr3",182142510,860,"Macaque",1,182143370
"chr16:335669:<DEL>:128:23161.28","<DEL>","chr16",335669,128,"Macaque",1,335797
"chr14:4808324:<DUP>:500:18905.71","<DUP>","chr14",4808324,500,"Macaque",1,4808824
"chr1:67373916:<DEL>:609:25106.13","<DEL>","chr1",67373916,609,"Macaque",1,67374525
"chr6:2411769:<DEL>:1023:18888.21","<DEL>","chr6",2411769,1023,"Macaque",1,2412792
"chr16:16044102:<DUP>:1285:37652.35","<DUP>","chr16",16044102,1285,"Macaque",1,16045387
"chr13:54253108:<DEL>:1150:29868.05","<DEL>","chr13",54253108,1150,"Macaque",1,54254258
"chr15:9262678:<DEL>:5981:11321.42","<DEL>","chr15",9262678,5981,"Macaque",1,9268659
"chr1:4022893:<DEL>:375:17960.62","<DEL>","chr1",4022893,375,"Macaque",1,4023268
"chr14:346933:<DEL>:533:72919.36","<DEL>","chr14",346933,533,"Macaque",1,347466
"chr2:114117192:<DEL>:434:19907.56","<DEL>","chr2",114117192,434,"Macaque",1,114117626
"chr1:94183877:<DEL>:942:30656.6","<DEL>","chr1",94183877,942,"Macaque",1,94184819
"chr12:107472785:<DEL>:824:54830.74","<DEL>","chr12",107472785,824,"Macaque",1,107473609
"chr2:195913403:<DEL>:2016:35185.02","<DEL>","chr2",195913403,2016,"Macaque",1,195915419
"chr11:128210653:<DEL>:843:11315.77","<DEL>","chr11",128210653,843,"Macaque",1,128211496
"chr7:29233749:<DEL>:671:50601.3","<DEL>","chr7",29233749,671,"Macaque",1,29234420
"chr14:115409568:<DEL>:492:40068.84","<DEL>","chr14",115409568,492,"Macaque",1,115410060
"chr16:3563007:<DEL>:566:14387.82","<DEL>","chr16",3563007,566,"Macaque",1,3563573
"chr15:2604245:<DEL>:735:46735.66","<DEL>","chr15",2604245,735,"Macaque",1,2604980
"chr9:102860216:<DEL>:1077:28636.56","<DEL>","chr9",102860216,1077,"Macaque",1,102861293
"chr4:34141371:<DEL>:393:28258.23","<DEL>","chr4",34141371,393,"Macaque",1,34141764
"chr18:46549391:<DEL>:730:44727.23","<DEL>","chr18",46549391,730,"Macaque",1,46550121
"chr8:79573583:<DEL>:523:61679.3","<DEL>","chr8",79573583,523,"Macaque",1,79574106
"chr1:153824217:<DEL>:554:11634.03","<DEL>","chr1",153824217,554,"Macaque",1,153824771
"chr4:44200010:<DEL>:544:34405.83","<DEL>","chr4",44200010,544,"Macaque",1,44200554
"chr3:160674811:<DUP>:29058:4744.13","<DUP>","chr3",160674811,29058,"Macaque",1,160703869
"chr2:17228457:<DEL>:5754:32474.03","<DEL>","chr2",17228457,5754,"Macaque",1,17234211
"chr1:83683802:<DEL>:1278:43045.2","<DEL>","chr1",83683802,1278,"Macaque",1,83685080
"chr2:84512081:<DEL>:583:19078.52","<DEL>","chr2",84512081,583,"Macaque",1,84512664
"chrX:56365862:<DUP>:5428:67897.12","<DUP>","chrX",56365862,5428,"Macaque",1,56371290
"chr14:62739599:<DEL>:747:40709.47","<DEL>","chr14",62739599,747,"Macaque",1,62740346
"chr11:87769573:<DEL>:1322:35185.03","<DEL>","chr11",87769573,1322,"Macaque",1,87770895
"chr16:50249871:<DEL>:768:10195.4","<DEL>","chr16",50249871,768,"Macaque",1,50250639
"chr1:11245091:<DEL>:603:21124.09","<DEL>","chr1",11245091,603,"Macaque",1,11245694
"chr3:83549168:<DEL>:1518:9846.27","<DEL>","chr3",83549168,1518,"Macaque",1,83550686
"chr8:2639252:<DEL>:979:15061.97","<DEL>","chr8",2639252,979,"Macaque",1,2640231
"chr3:102726363:<DEL>:67609:60118.82","<DEL>","chr3",102726363,67609,"Macaque",1,102793972
"chr2:152631913:<DEL>:37567:36898.46","<DEL>","chr2",152631913,37567,"Macaque",1,152669480
"chr6:6288773:<DEL>:8596:69365.62","<DEL>","chr6",6288773,8596,"Macaque",1,6297369
"chr1:84748147:<DEL>:604:12488.24","<DEL>","chr1",84748147,604,"Macaque",1,84748751
"chr15:926474:<DEL>:634:12915.11","<DEL>","chr15",926474,634,"Macaque",1,927108
"chr5:183599125:<DEL>:1020:22420.53","<DEL>","chr5",183599125,1020,"Macaque",1,183600145
"chr3:181552224:<DEL>:427:52830.03","<DEL>","chr3",181552224,427,"Macaque",1,181552651
"chr2:201978815:<DEL>:1035:31334.52","<DEL>","chr2",201978815,1035,"Macaque",1,201979850
"chr1:212424756:<DEL>:36802:68892.92","<DEL>","chr1",212424756,36802,"Macaque",1,212461558
"chr4:53339952:<DEL>:46124:19025.43","<DEL>","chr4",53339952,46124,"Macaque",1,53386076
"chr17:5101831:<DEL>:574:62245.88","<DEL>","chr17",5101831,574,"Macaque",1,5102405
"chr19:18532719:<DUP>:664:44234.7","<DUP>","chr19",18532719,664,"Macaque",1,18533383
"chr20:625886:<DEL>:663:64225.24","<DEL>","chr20",625886,663,"Macaque",1,626549
"chr3:116223561:<DEL>:960:25790.58","<DEL>","chr3",116223561,960,"Macaque",1,116224521
"chr11:109771469:<DEL>:765:14464.42","<DEL>","chr11",109771469,765,"Macaque",1,109772234
"chr10:316853:<DEL>:2817:66263.65","<DEL>","chr10",316853,2817,"Macaque",1,319670
"chr7:85338132:<DEL>:2686:36162.35","<DEL>","chr7",85338132,2686,"Macaque",1,85340818
"chr13:92156455:<DUP>:196:36686.17","<DUP>","chr13",92156455,196,"Macaque",1,92156651
"chr1:15028634:<DUP>:853:18915.21","<DUP>","chr1",15028634,853,"Macaque",1,15029487
"chr18:8897980:<DEL>:689:43180.16","<DEL>","chr18",8897980,689,"Macaque",1,8898669
"chr10:35516952:<DEL>:1586:25313.42","<DEL>","chr10",35516952,1586,"Macaque",1,35518538
"chr10:67230232:<DUP>:721:11147.65","<DUP>","chr10",67230232,721,"Macaque",1,67230953
"chr9:93552643:<DEL>:1292:11055.61","<DEL>","chr9",93552643,1292,"Macaque",1,93553935
"chr9:128450713:<DEL>:411:66590.18","<DEL>","chr9",128450713,411,"Macaque",1,128451124
"chr19:10314207:<DEL>:392:26923.46","<DEL>","chr19",10314207,392,"Macaque",1,10314599
"chr10:49421392:<DUP>:415:22638.81","<DUP>","chr10",49421392,415,"Macaque",1,49421807
"chr1:177513691:<DEL>:89963:37430.27","<DEL>","chr1",177513691,89963,"Macaque",1,177603654
