"SV.key","Type","Chromosome","Pos","Length","Genes","Num.genes","Species","SV.freq","end"
"9:97292915:<DEL>:325:1419.03:Lumpy:SVtyper:0.717","<DEL>","9",97292915,325,"intergenic",0,"Human",0.727659574,97293240
"12:38276820:<DEL>:317:457.9:Lumpy:SVtyper:0.004","<DEL>","12",38276820,317,"intergenic",0,"Human",0.008510638,38277137
"5:115465041:<DEL>:315:446.84:Lumpy:SVtyper:0.116","<DEL>","5",115465041,315,NA,0,"Human",0.204255319,115465356
"4:88083333:<DEL>:304:349.345:Lumpy:SVtyper:0.004","<DEL>","4",88083333,304,NA,0,"Human",0.008510638,88083637
"4:86310520:<DEL>:311:570.215:Lumpy:SVtyper:0.011","<DEL>","4",86310520,311,"intergenic",0,"Human",0.012765957,86310831
"17:3833430:<DEL>:300:749.84:Lumpy:SVtyper:0","<DEL>","17",3833430,300,"NM_174955;ATP2A3;1/22_exons",1,"Human",0.004255319,3833730
"9:2817244:<DEL>:279:505.63:Both:Both:0.004","<DEL>","9",2817244,279,NA,0,"Human",0.004255319,2817523
"17:79577695:<DEL>:323:104.32:Lumpy:SVtyper:0.007","<DEL>","17",79577695,323,NA,0,"Human",0.017021277,79578018
"2:188215728:<DEL>:307:2763.22:Lumpy:SVtyper:0.707","<DEL>","2",188215728,307,NA,0,"Human",0.812765957,188216035
"4:86660760:<DEL>:322:2906.99:Lumpy:SVtyper:0.011","<DEL>","4",86660760,322,NA,0,"Human",0.012765957,86661082
"1:1252215:<DEL>:301:159.90:Lumpy:SVtyper:0.007","<DEL>","1",1252215,301,NA,0,"Human",0.017021277,1252516
"6:4050243:<DEL>:319:473.26:Lumpy:SVtyper:0.007","<DEL>","6",4050243,319,NA,0,"Human",0.017021277,4050562
"1:1519498:<DEL>:304:767.22:Lumpy:SVtyper:0.004","<DEL>","1",1519498,304,"intergenic",0,"Human",0.004255319,1519802
"4:133114045:<DEL>:319:294.75:Lumpy:SVtyper:0.232","<DEL>","4",133114045,319,"intergenic",0,"Human",0.370212766,133114364
"9:22597436:<DEL>:315:432.14:Lumpy:SVtyper:0.011","<DEL>","9",22597436,315,"intergenic",0,"Human",0.025531915,22597751
"8:52061006:<DEL>:311:881.695:Lumpy:SVtyper:0.293","<DEL>","8",52061006,311,"intergenic",0,"Human",0.49787234,52061317
"5:20018903:<DEL>:310:838.40:Lumpy:SVtyper:0.007","<DEL>","5",20018903,310,"intergenic",0,"Human",0.012765957,20019213
"6:11556102:<DEL>:320:2750.30:Lumpy:SVtyper:0.804","<DEL>","6",11556102,320,NA,0,"Human",0.834042553,11556422
"3:1781985:<DEL>:309:1063.87:Lumpy:SVtyper:0.036","<DEL>","3",1781985,309,"intergenic",0,"Human",0.059574468,1782294
"4:31205821:<DEL>:319:1015.84:Lumpy:SVtyper:0.649","<DEL>","4",31205821,319,"intergenic",0,"Human",0.765957447,31206140
"5:162435380:<DEL>:315:470.03:Lumpy:SVtyper:0.029","<DEL>","5",162435380,315,"intergenic",0,"Human",0.038297872,162435695
"18:43261009:<DEL>:325:2813.74:Lumpy:SVtyper:0.808","<DEL>","18",43261009,325,NA,0,"Human",0.872340426,43261334
"22:25396140:<DEL>:320:351.91:Lumpy:SVtyper:0.293","<DEL>","22",25396140,320,"intergenic",0,"Human",0.49787234,25396460
"7:77959643:<DEL>:324:704.25:Lumpy:SVtyper:0.402","<DEL>","7",77959643,324,NA,0,"Human",0.574468085,77959967
"4:164501950:<DEL>:313:1081.93:Lumpy:SVtyper:0.007","<DEL>","4",164501950,313,NA,0,"Human",0.012765957,164502263
"4:134141603:<DEL>:309:433.615:Lumpy:SVtyper:0.007","<DEL>","4",134141603,309,"intergenic",0,"Human",0.012765957,134141912
"5:99759471:<DEL>:318:2089.755:Lumpy:SVtyper:0.007","<DEL>","5",99759471,318,"intergenic",0,"Human",0.012765957,99759789
"17:33888834:<DEL>:304:180.13:Lumpy:SVtyper:0.033","<DEL>","17",33888834,304,"intergenic",0,"Human",0.059574468,33889138
"2:58539308:<DEL>:325:909.60:Lumpy:SVtyper:0.018","<DEL>","2",58539308,325,"intergenic",0,"Human",0.025531915,58539633
"1:241360538:<DEL>:315:1514.705:Lumpy:SVtyper:0.011","<DEL>","1",241360538,315,NA,0,"Human",0.012765957,241360853
"6:4050243:<DEL>:319:2942.02:Lumpy:SVtyper:0.007","<DEL>","6",4050243,319,"NM_003913;PRPF4B;1/15_exons",1,"Human",0.017021277,4050562
"17:74987522:<DEL>:319:1686.345:Lumpy:SVtyper:0.007","<DEL>","17",74987522,319,"intergenic",0,"Human",0.021276596,74987841
"3:31532883:<DEL>:325:121.615:Lumpy:SVtyper:0.040","<DEL>","3",31532883,325,"intergenic",0,"Human",0.080851064,31533208
"2:206731192:<DEL>:323:280.71:Lumpy:SVtyper:0.004","<DEL>","2",206731192,323,"intergenic",0,"Human",0.012765957,206731515
"3:97435128:<DEL>:321:883.04:Lumpy:SVtyper:0.022","<DEL>","3",97435128,321,NA,0,"Human",0.038297872,97435449
"15:71452504:<DEL>:301:900.97:Lumpy:SVtyper:0.011","<DEL>","15",71452504,301,NA,0,"Human",0.029787234,71452805
"19:6163201:<DEL>:291:314.70:Lumpy:SVtyper:0.504","<DEL>","19",6163201,291,NA,0,"Human",0.706382979,6163492
"3:72379716:<DEL>:296:473.01:Lumpy:SVtyper:0.178","<DEL>","3",72379716,296,"intergenic",0,"Human",0.327659574,72380012
"15:74037088:<DEL>:319:398.29:Lumpy:SVtyper:0.036","<DEL>","15",74037088,319,NA,0,"Human",0.076595745,74037407
"9:87901409:<DEL>:308:1551.59:Lumpy:SVtyper:0.543","<DEL>","9",87901409,308,"intergenic",0,"Human",0.757446809,87901717
"13:29954765:<DEL>:324:559.03:Lumpy:SVtyper:0.645","<DEL>","13",29954765,324,NA,0,"Human",0.774468085,29955089
"10:20667251:<DEL>:320:1229.585:Lumpy:SVtyper:0.431","<DEL>","10",20667251,320,"intergenic",0,"Human",0.642553191,20667571
"12:22253182:<DEL>:325:779.08:Lumpy:SVtyper:0.011","<DEL>","12",22253182,325,"intergenic",0,"Human",0.017021277,22253507
"9:30345782:<DEL>:318:367.575:Lumpy:SVtyper:0.007","<DEL>","9",30345782,318,"intergenic",0,"Human",0.008510638,30346100
"11:7716906:<DEL>:316:1914.05:Lumpy:SVtyper:0.826","<DEL>","11",7716906,316,NA,0,"Human",0.855319149,7717222
"14:26701608:<DEL>:311:1995.25:Lumpy:SVtyper:0.478","<DEL>","14",26701608,311,"intergenic",0,"Human",0.676595745,26701919
"X:87743058:<DEL>:296:445.47:Lumpy:SVtyper:0.111","<DEL>","X",87743058,296,"intergenic",0,"Human",0.153191489,87743354
"15:83275279:<DEL>:311:177.16:Lumpy:SVtyper:0.011","<DEL>","15",83275279,311,NA,0,"Human",0.012765957,83275590
"12:90512326:<DEL>:306:826.68:Lumpy:SVtyper:0.007","<DEL>","12",90512326,306,"intergenic",0,"Human",0.017021277,90512632
"6:170206136:<DEL>:282:1023.81:Lumpy:SVtyper:0.159","<DEL>","6",170206136,282,"intergenic",0,"Human",0.234042553,170206418
"1:213913959:<DEL>:302:145.655:Lumpy:SVtyper:0.007","<DEL>","1",213913959,302,"intergenic",0,"Human",0.008510638,213914261
"7:48041733:<DEL>:322:341.805:Lumpy:SVtyper:0.004","<DEL>","7",48041733,322,NA,0,"Human",0.008510638,48042055
"2:142351001:<DEL>:325:1376.82:Lumpy:SVtyper:0.837","<DEL>","2",142351001,325,NA,0,"Human",0.838297872,142351326
"2:208567225:<DEL>:305:1201:Lumpy:SVtyper:0.768","<DEL>","2",208567225,305,"intergenic",0,"Human",0.821276596,208567530
"21:42936247:<DEL>:322:526.26:Lumpy:Both:0.004","<DEL>","21",42936247,322,"intergenic",0,"Human",0.008510638,42936569
"16:19506320:<DEL>:319:999.685:Lumpy:SVtyper:0.554","<DEL>","16",19506320,319,NA,0,"Human",0.706382979,19506639
"15:64633188:<DEL>:325:2638.225:Lumpy:SVtyper:0.688","<DEL>","15",64633188,325,NA,0,"Human",0.821276596,64633513
"16:86284309:<DEL>:308:632.65:Lumpy:SVtyper:0.616","<DEL>","16",86284309,308,"intergenic",0,"Human",0.774468085,86284617
"10:1465756:<DEL>:315:340.72:Lumpy:SVtyper:0.007","<DEL>","10",1465756,315,NA,0,"Human",0.012765957,1466071
"7:45650298:<DUP>:280:338.32:Lumpy:SVtyper:0.007","<DUP>","7",45650298,280,NA,0,"Human",0.017021277,45650578
"6:122301650:<DEL>:319:1370.525:Lumpy:SVtyper:0.750","<DEL>","6",122301650,319,"intergenic",0,"Human",0.834042553,122301969
"4:166468015:<DEL>:302:509.68:Lumpy:SVtyper:0.091","<DEL>","4",166468015,302,"intergenic",0,"Human",0.170212766,166468317
"9:10908810:<DEL>:290:730.135:Lumpy:SVtyper:0.069","<DEL>","9",10908810,290,"intergenic",0,"Human",0.144680851,10909100
"5:82156719:<DEL>:313:1412.56:Lumpy:SVtyper:0.275","<DEL>","5",82156719,313,"intergenic",0,"Human",0.459574468,82157032
"8:15001277:<DEL>:320:2288.83:Lumpy:SVtyper:0.011","<DEL>","8",15001277,320,NA,0,"Human",0.012765957,15001597
"9:71777932:<DEL>:318:752.66:Lumpy:SVtyper:0.402","<DEL>","9",71777932,318,NA,0,"Human",0.625531915,71778250
"7:145019686:<DEL>:285:1014.72:Lumpy:SVtyper:0.018","<DEL>","7",145019686,285,"intergenic",0,"Human",0.021276596,145019971
"9:30345782:<DEL>:318:590.85:Lumpy:SVtyper:0.007","<DEL>","9",30345782,318,"intergenic",0,"Human",0.017021277,30346100
"8:15053393:<DEL>:315:1050.11:Lumpy:SVtyper:0.036","<DEL>","8",15053393,315,NA,0,"Human",0.072340426,15053708
"13:113311766:<DEL>:306:215.06:Lumpy:SVtyper:0.004","<DEL>","13",113311766,306,NA,0,"Human",0.004255319,113312072
"8:61204996:<DEL>:317:556.74:Lumpy:SVtyper:0.004","<DEL>","8",61204996,317,"intergenic",0,"Human",0.004255319,61205313
"4:186348846:<DEL>:284:457.09:Lumpy:SVtyper:0.051","<DEL>","4",186348846,284,"intergenic",0,"Human",0.114893617,186349130
"6:132697631:<DEL>:323:1101.745:Lumpy:SVtyper:0.018","<DEL>","6",132697631,323,NA,0,"Human",0.029787234,132697954
"13:80081403:<DEL>:316:622.67:Lumpy:SVtyper:0.496","<DEL>","13",80081403,316,NA,0,"Human",0.65106383,80081719
"2:129363830:<DEL>:288:147.095:Lumpy:SVtyper:0.014","<DEL>","2",129363830,288,"intergenic",0,"Human",0.017021277,129364118
"12:17740950:<DEL>:302:769.77:Lumpy:SVtyper:0.004","<DEL>","12",17740950,302,"intergenic",0,"Human",0.008510638,17741252
"9:83630440:<DEL>:313:183.62:Lumpy:SVtyper:0.018","<DEL>","9",83630440,313,"intergenic",0,"Human",0.034042553,83630753
"6:7126468:<DUP>:320:168.41:Lumpy:SVtyper:0.004","<DUP>","6",7126468,320,NA,0,"Human",0.004255319,7126788
"3:64253007:<DEL>:299:544.73:Lumpy:SVtyper:0.004","<DEL>","3",64253007,299,"intergenic",0,"Human",0.004255319,64253306
"6:75957788:<DEL>:319:692.515:Lumpy:SVtyper:0.007","<DEL>","6",75957788,319,"intergenic",0,"Human",0.017021277,75958107
"3:74765417:<DEL>:323:1494.15:Lumpy:SVtyper:0.380","<DEL>","3",74765417,323,"intergenic",0,"Human",0.578723404,74765740
"5:172700240:<DEL>:316:834.77:Lumpy:SVtyper:0.130","<DEL>","5",172700240,316,"intergenic",0,"Human",0.229787234,172700556
"3:102810353:<DEL>:314:177.02:Lumpy:SVtyper:0.004","<DEL>","3",102810353,314,"intergenic",0,"Human",0.012765957,102810667
"12:128004169:<DEL>:298:1329.76:Lumpy:SVtyper:0.004","<DEL>","12",128004169,298,"intergenic",0,"Human",0.004255319,128004467
"10:113182707:<DEL>:296:416.62:Lumpy:SVtyper:0.004","<DEL>","10",113182707,296,"intergenic",0,"Human",0.008510638,113183003
"3:81907498:<DEL>:320:2266.18:Lumpy:SVtyper:0.844","<DEL>","3",81907498,320,"intergenic",0,"Human",0.872340426,81907818
"4:90548292:<DEL>:323:725.15:Lumpy:SVtyper:0.065","<DEL>","4",90548292,323,"intergenic",0,"Human",0.110638298,90548615
"13:21730902:<DEL>:323:2109.84:Lumpy:SVtyper:0.725","<DEL>","13",21730902,323,NA,0,"Human",0.808510638,21731225
"14:63621529:<DEL>:302:1084.62:Lumpy:SVtyper:0.438","<DEL>","14",63621529,302,"intergenic",0,"Human",0.642553191,63621831
"19:3994551:<DEL>:321:388.05:Lumpy:SVtyper:0.083","<DEL>","19",3994551,321,"intergenic",0,"Human",0.165957447,3994872
"3:99037449:<DEL>:312:2315.015:Lumpy:SVtyper:0.812","<DEL>","3",99037449,312,"intergenic",0,"Human",0.808510638,99037761
"2:25908631:<DEL>:300:741.60:Lumpy:SVtyper:0.004","<DEL>","2",25908631,300,"intergenic",0,"Human",0.012765957,25908931
"19:7426696:<DEL>:322:401.945:Lumpy:SVtyper:0.004","<DEL>","19",7426696,322,"intergenic",0,"Human",0.004255319,7427018
"20:19061421:<DEL>:313:387.24:Lumpy:SVtyper:0.007","<DEL>","20",19061421,313,"intergenic",0,"Human",0.021276596,19061734
"7:77959643:<DEL>:324:647.48:Lumpy:SVtyper:0.011","<DEL>","7",77959643,324,NA,0,"Human",0.012765957,77959967
"17:8031055:<DEL>:320:379.695:Lumpy:SVtyper:0.004","<DEL>","17",8031055,320,"intergenic",0,"Human",0.008510638,8031375
"3:57680952:<DEL>:302:900.17:Lumpy:SVtyper:0.007","<DEL>","3",57680952,302,"intergenic",0,"Human",0.008510638,57681254
"2:75001356:<DEL>:298:600.83:Lumpy:SVtyper:0.004","<DEL>","2",75001356,298,"intergenic",0,"Human",0.008510638,75001654
"7:2512152:<DEL>:292:479.61:Lumpy:SVtyper:0.004","<DEL>","7",2512152,292,"intergenic",0,"Human",0.008510638,2512444
"9:2000974:<DEL>:321:457.90:Lumpy:SVtyper:0.058","<DEL>","9",2000974,321,"intergenic",0,"Human",0.123404255,2001295
"3:155410972:<DEL>:325:313.625:Lumpy:SVtyper:0.004","<DEL>","3",155410972,325,NA,0,"Human",0.008510638,155411297
"15:79911587:<DEL>:312:466.53:Lumpy:SVtyper:0.007","<DEL>","15",79911587,312,"intergenic",0,"Human",0.012765957,79911899
"4:187559917:<DEL>:279:709.375:Lumpy:SVtyper:0.004","<DEL>","4",187559917,279,NA,0,"Human",0.008510638,187560196
"5:13895087:<DEL>:297:1447.045:Lumpy:SVtyper:0.754","<DEL>","5",13895087,297,NA,0,"Human",0.795744681,13895384
"15:66633819:<DEL>:321:1570.59:Lumpy:SVtyper:0.312","<DEL>","15",66633819,321,NA,0,"Human",0.378723404,66634140
"14:26701608:<DEL>:311:538.80:Lumpy:SVtyper:0.007","<DEL>","14",26701608,311,"intergenic",0,"Human",0.012765957,26701919
"13:29891563:<DEL>:311:1530.40:Lumpy:SVtyper:0.486","<DEL>","13",29891563,311,NA,0,"Human",0.672340426,29891874
"1:234587204:<DEL>:310:1224.225:Lumpy:SVtyper:0.011","<DEL>","1",234587204,310,NA,0,"Human",0.012765957,234587514
"14:48334249:<DEL>:315:604.60:Lumpy:SVtyper:0.678","<DEL>","14",48334249,315,"intergenic",0,"Human",0.812765957,48334564
"9:30491284:<DEL>:311:218.68:Lumpy:SVtyper:0.007","<DEL>","9",30491284,311,"intergenic",0,"Human",0.017021277,30491595
"2:213574683:<DEL>:306:855.68:Lumpy:SVtyper:0.341","<DEL>","2",213574683,306,"intergenic",0,"Human",0.536170213,213574989
"6:23300366:<DEL>:322:797.42:Lumpy:SVtyper:0.007","<DEL>","6",23300366,322,"intergenic",0,"Human",0.017021277,23300688
"11:92246001:<DEL>:304:838.68:Lumpy:SVtyper:0.297","<DEL>","11",92246001,304,NA,0,"Human",0.472340426,92246305
"5:31677431:<DEL>:323:2506.575:Lumpy:SVtyper:0.007","<DEL>","5",31677431,323,"intergenic",0,"Human",0.012765957,31677754
"11:7209296:<DEL>:317:174.20:Lumpy:SVtyper:0.004","<DEL>","11",7209296,317,"intergenic",0,"Human",0.008510638,7209613
"11:31152435:<DEL>:316:368.90:Lumpy:SVtyper:0.004","<DEL>","11",31152435,316,"intergenic",0,"Human",0.008510638,31152751
"14:59545308:<DEL>:307:808.48:Lumpy:SVtyper:0.420","<DEL>","14",59545308,307,"intergenic",0,"Human",0.642553191,59545615
"X:29821270:<DEL>:292:1198.17:Lumpy:SVtyper:0.005","<DEL>","X",29821270,292,NA,0,"Human",0.004255319,29821562
"5:71916556:<DEL>:304:1159.465:Lumpy:SVtyper:0.174","<DEL>","5",71916556,304,"intergenic",0,"Human",0.289361702,71916860
"13:114846308:<DUP>:293:126.63:Lumpy:SVtyper:0.018","<DUP>","13",114846308,293,NA,0,"Human",0.042553191,114846601
"18:22892485:<DEL>:324:3016.345:Lumpy:SVtyper:0.341","<DEL>","18",22892485,324,NA,0,"Human",0.54893617,22892809
"22:36798031:<DEL>:321:468.685:Lumpy:SVtyper:0.047","<DEL>","22",36798031,321,"intergenic",0,"Human",0.09787234,36798352
"6:40176760:<DEL>:309:540.69:Lumpy:SVtyper:0.007","<DEL>","6",40176760,309,"intergenic",0,"Human",0.012765957,40177069
"8:142507065:<DEL>:305:226.77:Lumpy:SVtyper:0.004","<DEL>","8",142507065,305,NA,0,"Human",0.004255319,142507370
"10:15532465:<DEL>:310:1087.68:Lumpy:SVtyper:0.500","<DEL>","10",15532465,310,"intergenic",0,"Human",0.668085106,15532775
"20:30899231:<DEL>:305:638.32:Lumpy:SVtyper:0.014","<DEL>","20",30899231,305,NA,0,"Human",0.025531915,30899536
"5:82482759:<DEL>:306:905.97:Lumpy:SVtyper:0.101","<DEL>","5",82482759,306,NA,0,"Human",0.153191489,82483065
"8:54204884:<DEL>:316:534.48:Lumpy:SVtyper:0.207","<DEL>","8",54204884,316,"intergenic",0,"Human",0.357446809,54205200
"14:49084556:<DEL>:309:792.16:Lumpy:SVtyper:0.011","<DEL>","14",49084556,309,"intergenic",0,"Human",0.017021277,49084865
"18:74365365:<DEL>:306:193.07:Lumpy:SVtyper:0.007","<DEL>","18",74365365,306,"intergenic",0,"Human",0.008510638,74365671
"11:75875964:<DUP>:284:209.43:Lumpy:SVtyper:0.004","<DUP>","11",75875964,284,"intergenic",0,"Human",0.008510638,75876248
"22:18283899:<DEL>:322:224.49:Lumpy:SVtyper:0.004","<DEL>","22",18283899,322,NA,0,"Human",0.004255319,18284221
"5:62304527:<DEL>:296:189.57:Lumpy:SVtyper:0.043","<DEL>","5",62304527,296,"intergenic",0,"Human",0.093617021,62304823
"3:17731688:<DEL>:325:1173.09:Lumpy:SVtyper:0.011","<DEL>","3",17731688,325,NA,0,"Human",0.012765957,17732013
"13:54524069:<DEL>:325:1007.23:Lumpy:SVtyper:0.145","<DEL>","13",54524069,325,"intergenic",0,"Human",0.259574468,54524394
"10:133925555:<DEL>:282:158.55:Lumpy:SVtyper:0.004","<DEL>","10",133925555,282,NA,0,"Human",0.004255319,133925837
"4:178893463:<DEL>:294:689.82:Lumpy:SVtyper:0.004","<DEL>","4",178893463,294,"intergenic",0,"Human",0.012765957,178893757
"6:55407897:<DEL>:278:706.81:Lumpy:SVtyper:0.246","<DEL>","6",55407897,278,NA,0,"Human",0.514893617,55408175
"7:148062980:<DEL>:322:865.84:Lumpy:SVtyper:0.319","<DEL>","7",148062980,322,NA,0,"Human",0.50212766,148063302
"12:31773731:<DEL>:298:778.00:Lumpy:SVtyper:0.018","<DEL>","12",31773731,298,"intergenic",0,"Human",0.034042553,31774029
"12:119901808:<DEL>:315:352.055:Lumpy:SVtyper:0.112","<DEL>","12",119901808,315,NA,0,"Human",0.212765957,119902123
"8:107511104:<DEL>:325:1831.455:Lumpy:SVtyper:0.601","<DEL>","8",107511104,325,NA,0,"Human",0.778723404,107511429
"17:3200737:<DEL>:319:1272.05:Lumpy:Both:0.004","<DEL>","17",3200737,319,"intergenic",0,"Human",0.004255319,3201056
"6:12617326:<DEL>:323:1069.53:Lumpy:SVtyper:0.004","<DEL>","6",12617326,323,"intergenic",0,"Human",0.004255319,12617649
"2:49612883:<DEL>:323:1696.12:Lumpy:SVtyper:0.732","<DEL>","2",49612883,323,"intergenic",0,"Human",0.846808511,49613206
"8:63307319:<DEL>:279:406.12:Lumpy:SVtyper:0.004","<DEL>","8",63307319,279,NA,0,"Human",0.004255319,63307598
"3:11646489:<DEL>:281:528.56:Lumpy:SVtyper:0.007","<DEL>","3",11646489,281,NA,0,"Human",0.012765957,11646770
"6:121319294:<DEL>:324:2290.33:Lumpy:SVtyper:0.685","<DEL>","6",121319294,324,"intergenic",0,"Human",0.8,121319618
"7:128309217:<DEL>:324:2148.74:Lumpy:SVtyper:0.786","<DEL>","7",128309217,324,"intergenic",0,"Human",0.795744681,128309541
"7:4829396:<DUP>:313:313.105:Lumpy:SVtyper:0.004","<DUP>","7",4829396,313,"NM_014855;AP5Z1;1/17_exons",1,"Human",0.008510638,4829709
"13:110812506:<DEL>:315:584.38:Lumpy:SVtyper:0.058","<DEL>","13",110812506,315,NA,0,"Human",0.106382979,110812821
"10:81086215:<DUP>:321:164.695:Lumpy:SVtyper:0.123","<DUP>","10",81086215,321,"intergenic",0,"Human",0.229787234,81086536
"4:722650:<DUP>:288:142.82:Lumpy:SVtyper:0.004","<DUP>","4",722650,288,NA,0,"Human",0.012765957,722938
"2:25227630:<DEL>:315:1099.47:Lumpy:SVtyper:0.674","<DEL>","2",25227630,315,"intergenic",0,"Human",0.8,25227945
"16:48816878:<DEL>:318:600.43:Lumpy:SVtyper:0.207","<DEL>","16",48816878,318,"intergenic",0,"Human",0.365957447,48817196
"11:82593534:<DEL>:310:634.80:Lumpy:SVtyper:0.011","<DEL>","11",82593534,310,NA,0,"Human",0.017021277,82593844
"11:12943734:<DEL>:277:232.98:Lumpy:SVtyper:0.007","<DEL>","11",12943734,277,NA,0,"Human",0.008510638,12944011
"20:60570633:<DEL>:319:1844.445:Lumpy:SVtyper:0.547","<DEL>","20",60570633,319,NA,0,"Human",0.753191489,60570952
"17:29932465:<DEL>:312:721.24:Lumpy:SVtyper:0.007","<DEL>","17",29932465,312,"intergenic",0,"Human",0.012765957,29932777
"6:159652114:<DEL>:313:2131.69:Lumpy:SVtyper:0.007","<DEL>","6",159652114,313,NA,0,"Human",0.012765957,159652427
"15:48550271:<DEL>:320:339.51:Lumpy:SVtyper:0.007","<DEL>","15",48550271,320,NA,0,"Human",0.012765957,48550591
"12:10407413:<DEL>:309:320.90:Lumpy:SVtyper:0.043","<DEL>","12",10407413,309,"intergenic",0,"Human",0.093617021,10407722
"2:20666676:<DEL>:307:1287.95:Lumpy:SVtyper:0.471","<DEL>","2",20666676,307,"intergenic",0,"Human",0.663829787,20666983
"9:94148167:<DEL>:323:862.95:Lumpy:SVtyper:0.036","<DEL>","9",94148167,323,"intergenic",0,"Human",0.059574468,94148490
"3:186826659:<DEL>:314:1148.4:Lumpy:SVtyper:0.007","<DEL>","3",186826659,314,"intergenic",0,"Human",0.012765957,186826973
"17:13704553:<DEL>:289:174.19:Lumpy:SVtyper:0.004","<DEL>","17",13704553,289,"intergenic",0,"Human",0.017021277,13704842
"21:18426883:<DEL>:285:428.77:Lumpy:SVtyper:0.014","<DEL>","21",18426883,285,"intergenic",0,"Human",0.025531915,18427168
"1:245845702:<DEL>:305:452.78:Lumpy:SVtyper:0.014","<DEL>","1",245845702,305,NA,0,"Human",0.029787234,245846007
"1:248849862:<DEL>:277:768.83:Lumpy:SVtyper:0.098","<DEL>","1",248849862,277,"intergenic",0,"Human",0.195744681,248850139
"9:78736730:<DEL>:312:2024.285:Lumpy:SVtyper:0.464","<DEL>","9",78736730,312,NA,0,"Human",0.685106383,78737042
"4:177869328:<DEL>:316:578.97:Lumpy:SVtyper:0.007","<DEL>","4",177869328,316,"intergenic",0,"Human",0.012765957,177869644
"6:29513087:<DEL>:314:1010.73:Lumpy:SVtyper:0.004","<DEL>","6",29513087,314,"intergenic",0,"Human",0.004255319,29513401
"8:4941227:<DEL>:297:299.59:Lumpy:SVtyper:0.004","<DEL>","8",4941227,297,"intergenic",0,"Human",0.004255319,4941524
"12:32963609:<DEL>:315:675.12:Lumpy:SVtyper:0.714","<DEL>","12",32963609,315,NA,0,"Human",0.863829787,32963924
"7:103463077:<DEL>:322:1805.48:Lumpy:SVtyper:0.757","<DEL>","7",103463077,322,NA,0,"Human",0.829787234,103463399
"3:54024998:<DUP>:301:283.00:Lumpy:SVtyper:0.257","<DUP>","3",54024998,301,"intergenic",0,"Human",0.50212766,54025299
"3:195653516:<DEL>:315:889.92:Lumpy:SVtyper:0.043","<DEL>","3",195653516,315,"intergenic",0,"Human",0.093617021,195653831
"7:136851616:<DEL>:311:680.25:Lumpy:SVtyper:0.315","<DEL>","7",136851616,311,"intergenic",0,"Human",0.485106383,136851927
"6:134817361:<DEL>:317:332.495:Lumpy:SVtyper:0.007","<DEL>","6",134817361,317,"intergenic",0,"Human",0.012765957,134817678
"12:13017638:<DEL>:314:1501.55:Lumpy:SVtyper:0.116","<DEL>","12",13017638,314,"intergenic",0,"Human",0.212765957,13017952
"4:163232412:<DEL>:309:587.475:Lumpy:SVtyper:0.022","<DEL>","4",163232412,309,"intergenic",0,"Human",0.034042553,163232721
"8:19980270:<DEL>:315:1022.2:Lumpy:SVtyper:0.174","<DEL>","8",19980270,315,"intergenic",0,"Human",0.289361702,19980585
"4:189793244:<DEL>:319:279.09:Lumpy:SVtyper:0.007","<DEL>","4",189793244,319,"intergenic",0,"Human",0.012765957,189793563
"3:195653516:<DEL>:315:474.89:Lumpy:SVtyper:0.004","<DEL>","3",195653516,315,"intergenic",0,"Human",0.004255319,195653831
"7:49552067:<DEL>:318:1213.935:Lumpy:SVtyper:0.004","<DEL>","7",49552067,318,"intergenic",0,"Human",0.008510638,49552385
"1:225762322:<DEL>:319:607.845:Lumpy:SVtyper:0.699","<DEL>","1",225762322,319,NA,0,"Human",0.8,225762641
"12:212694:<DUP>:324:155.65:Lumpy:SVtyper:0.014","<DUP>","12",212694,324,NA,0,"Human",0.021276596,213018
"3:52625727:<DEL>:301:118.64:Lumpy:SVtyper:0.007","<DEL>","3",52625727,301,NA,0,"Human",0.012765957,52626028
"19:53820794:<DEL>:315:340.325:Lumpy:SVtyper:0.207","<DEL>","19",53820794,315,"intergenic",0,"Human",0.340425532,53821109
"12:45011190:<DEL>:305:1449.91:Lumpy:SVtyper:0.109","<DEL>","12",45011190,305,NA,0,"Human",0.187234043,45011495
"19:12557705:<DEL>:289:665.54:Lumpy:SVtyper:0.051","<DEL>","19",12557705,289,"intergenic",0,"Human",0.089361702,12557994
"22:49077627:<DEL>:276:431.205:Lumpy:SVtyper:0.442","<DEL>","22",49077627,276,NA,0,"Human",0.706382979,49077903
"3:162408300:<DEL>:316:800.255:Lumpy:SVtyper:0.098","<DEL>","3",162408300,316,"intergenic",0,"Human",0.161702128,162408616
"1:79401511:<DEL>:322:138.465:Lumpy:SVtyper:0.004","<DEL>","1",79401511,322,"NM_022159;ELTD1;1/15_exons",1,"Human",0.008510638,79401833
"2:163666414:<DEL>:315:1573.56:Lumpy:SVtyper:0.007","<DEL>","2",163666414,315,NA,0,"Human",0.012765957,163666729
"13:22523531:<DEL>:318:1157.66:Lumpy:SVtyper:0.152","<DEL>","13",22523531,318,"intergenic",0,"Human",0.25106383,22523849
"8:109959287:<DEL>:325:505.37:Lumpy:SVtyper:0.018","<DEL>","8",109959287,325,"intergenic",0,"Human",0.034042553,109959612
"4:183438517:<DEL>:319:643.84:Lumpy:SVtyper:0.047","<DEL>","4",183438517,319,NA,0,"Human",0.089361702,183438836
"4:3827785:<DEL>:294:1180.28:Lumpy:SVtyper:0.188","<DEL>","4",3827785,294,"intergenic",0,"Human",0.357446809,3828079
"10:36411874:<DEL>:319:600.56:Lumpy:SVtyper:0.047","<DEL>","10",36411874,319,"intergenic",0,"Human",0.09787234,36412193
"5:17895105:<DEL>:289:483.51:Lumpy:SVtyper:0.004","<DEL>","5",17895105,289,"intergenic",0,"Human",0.004255319,17895394
"8:92152864:<DEL>:324:1024.075:Lumpy:SVtyper:0.493","<DEL>","8",92152864,324,NA,0,"Human",0.723404255,92153188
"11:76403570:<DEL>:312:605.69:Lumpy:SVtyper:0.011","<DEL>","11",76403570,312,"intergenic",0,"Human",0.025531915,76403882
"19:23740643:<DEL>:319:351.24:Lumpy:SVtyper:0.007","<DEL>","19",23740643,319,"intergenic",0,"Human",0.012765957,23740962
"4:69036902:<DEL>:321:643.96:Lumpy:SVtyper:0.007","<DEL>","4",69036902,321,"intergenic",0,"Human",0.017021277,69037223
"8:98200148:<DEL>:322:1048.50:Lumpy:SVtyper:0.101","<DEL>","8",98200148,322,"intergenic",0,"Human",0.191489362,98200470
"9:73463610:<DEL>:316:480.68:Lumpy:SVtyper:0.007","<DEL>","9",73463610,316,NA,0,"Human",0.021276596,73463926
"18:68724366:<DEL>:310:796.88:Lumpy:SVtyper:0.025","<DEL>","18",68724366,310,"intergenic",0,"Human",0.055319149,68724676
"11:37666634:<DEL>:307:1574.91:Lumpy:SVtyper:0.123","<DEL>","11",37666634,307,"intergenic",0,"Human",0.212765957,37666941
"12:13017638:<DEL>:314:593.95:Lumpy:SVtyper:0.007","<DEL>","12",13017638,314,"intergenic",0,"Human",0.008510638,13017952
"19:981314:<DEL>:279:886.14:Lumpy:SVtyper:0.004","<DEL>","19",981314,279,"intergenic",0,"Human",0.004255319,981593
"5:146781905:<DEL>:312:458.97:Lumpy:SVtyper:0.007","<DEL>","5",146781905,312,NA,0,"Human",0.017021277,146782217
"9:74269391:<DEL>:281:1047.545:Lumpy:SVtyper:0.011","<DEL>","9",74269391,281,"intergenic",0,"Human",0.012765957,74269672
"7:68462081:<DEL>:319:2127.9:Lumpy:SVtyper:0.667","<DEL>","7",68462081,319,"intergenic",0,"Human",0.778723404,68462400
"10:105097527:<DEL>:314:1277.72:Lumpy:SVtyper:0.007","<DEL>","10",105097527,314,NA,0,"Human",0.008510638,105097841
"6:32460897:<DEL>:322:740.41:Lumpy:SVtyper:0.170","<DEL>","6",32460897,322,"intergenic",0,"Human",0.234042553,32461219
"4:83179789:<DEL>:312:926.33:Lumpy:SVtyper:0.210","<DEL>","4",83179789,312,"intergenic",0,"Human",0.34893617,83180101
"14:104841522:<DEL>:302:222.07:Lumpy:SVtyper:0.004","<DEL>","14",104841522,302,"intergenic",0,"Human",0.004255319,104841824
"8:478392:<DEL>:277:776.65:Lumpy:SVtyper:0.101","<DEL>","8",478392,277,NA,0,"Human",0.182978723,478669
"6:97505054:<DEL>:317:427.43:Lumpy:SVtyper:0.127","<DEL>","6",97505054,317,NA,0,"Human",0.238297872,97505371
"20:59974172:<DEL>:321:570.89:Lumpy:SVtyper:0.011","<DEL>","20",59974172,321,NA,0,"Human",0.012765957,59974493
"2:151903087:<DEL>:276:2824.895:Lumpy:SVtyper:0.007","<DEL>","2",151903087,276,"intergenic",0,"Human",0.012765957,151903363
"2:61848163:<DEL>:280:859.17:Lumpy:SVtyper:0.004","<DEL>","2",61848163,280,"intergenic",0,"Human",0.008510638,61848443
"21:15926724:<DEL>:314:439.965:Lumpy:SVtyper:0.004","<DEL>","21",15926724,314,NA,0,"Human",0.008510638,15927038
"4:117251479:<DEL>:317:2265.81:Lumpy:SVtyper:0.721","<DEL>","4",117251479,317,"intergenic",0,"Human",0.8,117251796
"12:129840690:<DEL>:313:274.79:Lumpy:SVtyper:0.018","<DEL>","12",129840690,313,NA,0,"Human",0.029787234,129841003
"17:15863577:<DEL>:318:1826.64:Lumpy:SVtyper:0.467","<DEL>","17",15863577,318,NA,0,"Human",0.757446809,15863895
"16:72074293:<DEL>:297:627.795:Lumpy:SVtyper:0.018","<DEL>","16",72074293,297,"intergenic",0,"Human",0.034042553,72074590
"9:442598:<DEL>:281:528.82:Lumpy:SVtyper:0.004","<DEL>","9",442598,281,NA,0,"Human",0.004255319,442879
"11:31152435:<DEL>:316:566.58:Lumpy:SVtyper:0.464","<DEL>","11",31152435,316,"intergenic",0,"Human",0.70212766,31152751
"18:26363754:<DEL>:321:1947.785:Lumpy:SVtyper:0.819","<DEL>","18",26363754,321,"intergenic",0,"Human",0.842553191,26364075
"2:233668372:<DEL>:305:711.93:Lumpy:SVtyper:0.543","<DEL>","2",233668372,305,NA,0,"Human",0.753191489,233668677
"16:530778:<DEL>:311:320.36:Lumpy:SVtyper:0.221","<DEL>","16",530778,311,NA,0,"Human",0.378723404,531089
"3:31543677:<DEL>:296:429.32:Lumpy:SVtyper:0.054","<DEL>","3",31543677,296,"intergenic",0,"Human",0.114893617,31543973
"5:104388693:<DEL>:315:322.79:Lumpy:SVtyper:0.033","<DEL>","5",104388693,315,"intergenic",0,"Human",0.05106383,104389008
"6:108266117:<DEL>:303:1532.055:Lumpy:SVtyper:0.721","<DEL>","6",108266117,303,NA,0,"Human",0.795744681,108266420
"22:18623682:<DEL>:298:516.545:Lumpy:SVtyper:0.004","<DEL>","22",18623682,298,"intergenic",0,"Human",0.008510638,18623980
"3:116275279:<DEL>:324:608.235:Both:Both:0.007","<DEL>","3",116275279,324,"intergenic",0,"Human",0.021276596,116275603
"7:135131654:<DEL>:310:856.07:Both:Both:0.214","<DEL>","7",135131654,310,NA,0,"Human",0.387234043,135131964
"1:4271202:<DEL>:282:1139.64:Lumpy:SVtyper:0.004","<DEL>","1",4271202,282,"intergenic",0,"Human",0.004255319,4271484
"2:85335362:<DEL>:318:524.775:Lumpy:SVtyper:0.004","<DEL>","2",85335362,318,"intergenic",0,"Human",0.004255319,85335680
"1:70768116:<DEL>:323:676.61:Lumpy:SVtyper:0.116","<DEL>","1",70768116,323,NA,0,"Human",0.217021277,70768439
"16:61201903:<DEL>:318:723.27:Lumpy:SVtyper:0.004","<DEL>","16",61201903,318,"intergenic",0,"Human",0.004255319,61202221
"17:73542607:<DEL>:277:1398.56:Lumpy:SVtyper:0.236","<DEL>","17",73542607,277,NA,0,"Human",0.361702128,73542884
"7:12281712:<DEL>:325:798.775:Lumpy:SVtyper:0.377","<DEL>","7",12281712,325,"intergenic",0,"Human",0.561702128,12282037
"6:1270714:<DEL>:285:715.71:Lumpy:SVtyper:0.170","<DEL>","6",1270714,285,"intergenic",0,"Human",0.289361702,1270999
"7:30897059:<DEL>:304:736.20:Lumpy:SVtyper:0.167","<DEL>","7",30897059,304,NA,0,"Human",0.29787234,30897363
"10:19030267:<DEL>:290:2003.43:Lumpy:SVtyper:0.011","<DEL>","10",19030267,290,"intergenic",0,"Human",0.017021277,19030557
"5:151760909:<DEL>:315:613.22:Lumpy:SVtyper:0.145","<DEL>","5",151760909,315,"intergenic",0,"Human",0.272340426,151761224
"X:22672576:<DEL>:315:1422.845:Lumpy:SVtyper:0.309","<DEL>","X",22672576,315,"intergenic",0,"Human",0.344680851,22672891
"2:240838454:<DEL>:308:304.865:Lumpy:SVtyper:0.007","<DEL>","2",240838454,308,"intergenic",0,"Human",0.012765957,240838762
"15:101453077:<DEL>:309:1123.73:Lumpy:SVtyper:0.014","<DEL>","15",101453077,309,NA,0,"Human",0.029787234,101453386
"11:1971658:<DEL>:285:928.055:Lumpy:SVtyper:0.011","<DEL>","11",1971658,285,NA,0,"Human",0.012765957,1971943
"1:234587204:<DEL>:310:1116.59:Lumpy:SVtyper:0.011","<DEL>","1",234587204,310,NA,0,"Human",0.012765957,234587514
"12:8625581:<DEL>:311:1865.75:Lumpy:SVtyper:0.696","<DEL>","12",8625581,311,NA,0,"Human",0.838297872,8625892
"3:45768353:<DEL>:325:782.31:Lumpy:SVtyper:0.007","<DEL>","3",45768353,325,NA,0,"Human",0.017021277,45768678
"4:44822057:<DEL>:288:639.13:Lumpy:SVtyper:0.004","<DEL>","4",44822057,288,"intergenic",0,"Human",0.004255319,44822345
"10:30844930:<DEL>:280:926.06:Lumpy:SVtyper:0.004","<DEL>","10",30844930,280,"intergenic",0,"Human",0.004255319,30845210
"11:132558594:<DEL>:289:452.505:Lumpy:SVtyper:0.326","<DEL>","11",132558594,289,NA,0,"Human",0.570212766,132558883
"4:83303550:<DEL>:312:606.22:Lumpy:SVtyper:0.004","<DEL>","4",83303550,312,"intergenic",0,"Human",0.004255319,83303862
"7:136834457:<DEL>:302:1256.14:Lumpy:SVtyper:0.308","<DEL>","7",136834457,302,"intergenic",0,"Human",0.480851064,136834759
"2:208567225:<DEL>:305:800.925:Lumpy:SVtyper:0.007","<DEL>","2",208567225,305,"intergenic",0,"Human",0.021276596,208567530
"10:115861724:<DEL>:309:339.245:Lumpy:SVtyper:0.163","<DEL>","10",115861724,309,"intergenic",0,"Human",0.306382979,115862033
"1:69806997:<DEL>:319:1298.83:Lumpy:SVtyper:0.797","<DEL>","1",69806997,319,"intergenic",0,"Human",0.821276596,69807316
"16:65520002:<DEL>:321:564.56:Lumpy:SVtyper:0.029","<DEL>","16",65520002,321,"intergenic",0,"Human",0.05106383,65520323
"2:196736415:<DEL>:279:373.09:Lumpy:SVtyper:0.123","<DEL>","2",196736415,279,NA,0,"Human",0.242553191,196736694
"7:37998511:<DEL>:315:972.04:Lumpy:SVtyper:0.007","<DEL>","7",37998511,315,"intergenic",0,"Human",0.017021277,37998826
"9:136414107:<DEL>:324:1494.81:Lumpy:SVtyper:0.696","<DEL>","9",136414107,324,NA,0,"Human",0.787234043,136414431
"3:33300945:<DEL>:308:753.73:Lumpy:SVtyper:0.130","<DEL>","3",33300945,308,"intergenic",0,"Human",0.242553191,33301253
"8:138860558:<DEL>:324:515.88:Lumpy:SVtyper:0.565","<DEL>","8",138860558,324,"intergenic",0,"Human",0.74893617,138860882
"3:76251930:<DEL>:304:685.1:Lumpy:SVtyper:0.004","<DEL>","3",76251930,304,"intergenic",0,"Human",0.008510638,76252234
"8:85223001:<DEL>:325:564.015:Lumpy:SVtyper:0.040","<DEL>","8",85223001,325,NA,0,"Human",0.072340426,85223326
"1:103096076:<DEL>:319:2993.84:Lumpy:SVtyper:0.830","<DEL>","1",103096076,319,"intergenic",0,"Human",0.85106383,103096395
"6:41705659:<DEL>:309:243.50:Lumpy:SVtyper:0.007","<DEL>","6",41705659,309,NA,0,"Human",0.008510638,41705968
"6:134817361:<DEL>:317:2349.885:Lumpy:SVtyper:0.591","<DEL>","6",134817361,317,"intergenic",0,"Human",0.710638298,134817678
"8:1902983:<DEL>:307:170.40:Lumpy:SVtyper:0.004","<DEL>","8",1902983,307,NA,0,"Human",0.008510638,1903290
"16:60032089:<DEL>:314:1911.83:Lumpy:SVtyper:0.641","<DEL>","16",60032089,314,"intergenic",0,"Human",0.778723404,60032403
"5:103030557:<DEL>:325:1226.075:Lumpy:SVtyper:0.525","<DEL>","5",103030557,325,"intergenic",0,"Human",0.74893617,103030882
"11:64623156:<DEL>:311:522.89:Lumpy:SVtyper:0.007","<DEL>","11",64623156,311,NA,0,"Human",0.017021277,64623467
"6:158876084:<DEL>:321:672.96:Lumpy:SVtyper:0.362","<DEL>","6",158876084,321,NA,0,"Human",0.617021277,158876405
"17:78608095:<DUP>:297:243.58:Lumpy:SVtyper:0.054","<DUP>","17",78608095,297,NA,0,"Human",0.106382979,78608392
"8:127426483:<DEL>:275:392.9:Lumpy:SVtyper:0.004","<DEL>","8",127426483,275,"intergenic",0,"Human",0.008510638,127426758
"7:158233594:<DUP>:314:208.21:Lumpy:SVtyper:0.080","<DUP>","7",158233594,314,NA,0,"Human",0.170212766,158233908
"5:179540444:<DEL>:293:104.9:Lumpy:SVtyper:0.004","<DEL>","5",179540444,293,NA,0,"Human",0.004255319,179540737
"19:51776400:<DEL>:311:1050.64:Lumpy:SVtyper:0.025","<DEL>","19",51776400,311,"intergenic",0,"Human",0.038297872,51776711
"10:29719300:<DEL>:289:667.71:Lumpy:SVtyper:0.007","<DEL>","10",29719300,289,"intergenic",0,"Human",0.012765957,29719589
"5:13895087:<DEL>:297:2600.235:Lumpy:SVtyper:0.014","<DEL>","5",13895087,297,NA,0,"Human",0.012765957,13895384
"12:92497624:<DEL>:295:752.645:Lumpy:SVtyper:0.004","<DEL>","12",92497624,295,NA,0,"Human",0.008510638,92497919
"5:99174316:<DEL>:314:192.795:Both:Both:0.007","<DEL>","5",99174316,314,"intergenic",0,"Human",0.012765957,99174630
"8:27879721:<DEL>:283:646.67:Lumpy:SVtyper:0.004","<DEL>","8",27879721,283,NA,0,"Human",0.004255319,27880004
"7:32459694:<DEL>:287:435.53:Lumpy:SVtyper:0.040","<DEL>","7",32459694,287,"intergenic",0,"Human",0.063829787,32459981
"18:1852003:<DEL>:324:844.34:Lumpy:SVtyper:0.123","<DEL>","18",1852003,324,"intergenic",0,"Human",0.221276596,1852327
"13:87155191:<DEL>:305:621.86:Lumpy:SVtyper:0.120","<DEL>","13",87155191,305,"intergenic",0,"Human",0.229787234,87155496
"1:56996033:<DUP>:313:480.955:Lumpy:SVtyper:0.250","<DUP>","1",56996033,313,NA,0,"Human",0.476595745,56996346
"3:19006074:<DEL>:281:665.28:Lumpy:SVtyper:0.004","<DEL>","3",19006074,281,"intergenic",0,"Human",0.004255319,19006355
"9:10498746:<DEL>:310:814.40:Both:Both:0.007","<DEL>","9",10498746,310,NA,0,"Human",0.012765957,10499056
"19:18242162:<DEL>:320:504.83:Lumpy:SVtyper:0.192","<DEL>","19",18242162,320,NA,0,"Human",0.344680851,18242482
"6:22782654:<DEL>:324:633.73:Lumpy:SVtyper:0.004","<DEL>","6",22782654,324,"intergenic",0,"Human",0.008510638,22782978
"2:240001592:<DEL>:296:816.84:Both:Both:0.004","<DEL>","2",240001592,296,NA,0,"Human",0.004255319,240001888
"7:90583933:<DEL>:307:509.13:Lumpy:SVtyper:0.007","<DEL>","7",90583933,307,NA,0,"Human",0.012765957,90584240
"6:108266117:<DEL>:304:1368.755:Lumpy:SVtyper:0.007","<DEL>","6",108266117,304,NA,0,"Human",0.012765957,108266421
"5:5810385:<DUP>:298:219.45:Lumpy:SVtyper:0.094","<DUP>","5",5810385,298,"intergenic",0,"Human",0.157446809,5810683
"2:16251108:<DEL>:325:761.01:Lumpy:SVtyper:0.362","<DEL>","2",16251108,325,"intergenic",0,"Human",0.544680851,16251433
"6:50765965:<DEL>:311:599.20:Lumpy:SVtyper:0.007","<DEL>","6",50765965,311,"intergenic",0,"Human",0.017021277,50766276
"19:6152277:<DEL>:285:1050.06:Lumpy:SVtyper:0.395","<DEL>","19",6152277,285,NA,0,"Human",0.65106383,6152562
"11:41007027:<DEL>:322:2199.43:Lumpy:SVtyper:0.812","<DEL>","11",41007027,322,NA,0,"Human",0.808510638,41007349
"3:114466475:<DEL>:324:2079.23:Lumpy:SVtyper:0.736","<DEL>","3",114466475,324,NA,0,"Human",0.804255319,114466799
"7:158233709:<DUP>:278:1305.59:Lumpy:SVtyper:0.004","<DUP>","7",158233709,278,NA,0,"Human",0.004255319,158233987
"4:125671743:<DEL>:319:475.83:Lumpy:SVtyper:0.246","<DEL>","4",125671743,319,"intergenic",0,"Human",0.421276596,125672062
"9:116138534:<DEL>:294:251.33:Lumpy:SVtyper:0.014","<DEL>","9",116138534,294,NA,0,"Human",0.029787234,116138828
"5:3499272:<DEL>:321:1530.41:Lumpy:SVtyper:0.630","<DEL>","5",3499272,321,"intergenic",0,"Human",0.795744681,3499593
"2:173888923:<DEL>:324:636.83:Lumpy:SVtyper:0.036","<DEL>","2",173888923,324,NA,0,"Human",0.055319149,173889247
"9:23115022:<DEL>:301:900.835:Lumpy:SVtyper:0.018","<DEL>","9",23115022,301,"intergenic",0,"Human",0.042553191,23115323
"X:96006640:<DEL>:315:673.38:Lumpy:SVtyper:0.024","<DEL>","X",96006640,315,NA,0,"Human",0.029787234,96006955
"14:38643499:<DEL>:317:1001.57:Lumpy:SVtyper:0.007","<DEL>","14",38643499,317,"intergenic",0,"Human",0.012765957,38643816
"4:8760595:<DEL>:289:118.15:Lumpy:SVtyper:0.091","<DEL>","4",8760595,289,"intergenic",0,"Human",0.182978723,8760884
"5:124717350:<DEL>:322:1689.68:Lumpy:SVtyper:0.004","<DEL>","5",124717350,322,"intergenic",0,"Human",0.004255319,124717672
"9:78736730:<DEL>:312:232.985:Lumpy:SVtyper:0.007","<DEL>","9",78736730,312,NA,0,"Human",0.012765957,78737042
"4:190253845:<DEL>:322:2401.50:Lumpy:SVtyper:0.844","<DEL>","4",190253845,322,"intergenic",0,"Human",0.893617021,190254167
"2:183315820:<DEL>:315:793.38:Lumpy:SVtyper:0.475","<DEL>","2",183315820,315,NA,0,"Human",0.676595745,183316135
"5:23633207:<DEL>:279:100.85:Lumpy:SVtyper:0.004","<DEL>","5",23633207,279,"intergenic",0,"Human",0.008510638,23633486
"7:522865:<DEL>:304:316.055:Lumpy:SVtyper:0.007","<DEL>","7",522865,304,"intergenic",0,"Human",0.012765957,523169
"13:47689479:<DEL>:314:1504.21:Lumpy:SVtyper:0.674","<DEL>","13",47689479,314,"intergenic",0,"Human",0.787234043,47689793
"7:12058713:<DEL>:324:785.02:Lumpy:SVtyper:0.337","<DEL>","7",12058713,324,"intergenic",0,"Human",0.510638298,12059037
"8:139704237:<DEL>:286:171.355:Lumpy:SVtyper:0.014","<DEL>","8",139704237,286,NA,0,"Human",0.029787234,139704523
"19:49670394:<DEL>:302:240.00:Lumpy:SVtyper:0.004","<DEL>","19",49670394,302,NA,0,"Human",0.012765957,49670696
"11:38686789:<DEL>:306:792.435:Both:Both:0.004","<DEL>","11",38686789,306,"intergenic",0,"Human",0.008510638,38687095
"4:39031082:<DEL>:282:1919.82:Lumpy:SVtyper:0.518","<DEL>","4",39031082,282,NA,0,"Human",0.710638298,39031364
"20:54463223:<DEL>:317:742.41:Lumpy:SVtyper:0.565","<DEL>","20",54463223,317,"intergenic",0,"Human",0.731914894,54463540
"X:24101377:<DEL>:315:254.84:Lumpy:SVtyper:0.285","<DEL>","X",24101377,315,"intergenic",0,"Human",0.361702128,24101692
"20:58926722:<DEL>:321:1081.385:Lumpy:SVtyper:0.029","<DEL>","20",58926722,321,"intergenic",0,"Human",0.072340426,58927043
"17:73763000:<DUP>:303:174.19:Lumpy:SVtyper:0.022","<DUP>","17",73763000,303,"intergenic",0,"Human",0.034042553,73763303
"15:58931993:<DEL>:283:829.375:Lumpy:SVtyper:0.004","<DEL>","15",58931993,283,NA,0,"Human",0.008510638,58932276
"3:81346078:<DEL>:315:806.86:Lumpy:SVtyper:0.279","<DEL>","3",81346078,315,"intergenic",0,"Human",0.434042553,81346393
"16:67513810:<DEL>:318:519.65:Lumpy:SVtyper:0.047","<DEL>","16",67513810,318,NA,0,"Human",0.093617021,67514128
"16:61459644:<DEL>:305:518.315:Lumpy:SVtyper:0.312","<DEL>","16",61459644,305,"intergenic",0,"Human",0.514893617,61459949
"5:5076614:<DEL>:293:348.265:Lumpy:SVtyper:0.004","<DEL>","5",5076614,293,"intergenic",0,"Human",0.008510638,5076907
"16:936519:<DEL>:297:188.905:Lumpy:SVtyper:0.004","<DEL>","16",936519,297,NA,0,"Human",0.017021277,936816
"9:75669523:<DEL>:279:1970.82:Lumpy:SVtyper:0.764","<DEL>","9",75669523,279,"intergenic",0,"Human",0.834042553,75669802
"11:1148460:<DUP>:323:248.375:Lumpy:SVtyper:0.178","<DUP>","11",1148460,323,"intergenic",0,"Human",0.353191489,1148783
"6:41953355:<DEL>:315:1132.535:Lumpy:SVtyper:0.801","<DEL>","6",41953355,315,NA,0,"Human",0.795744681,41953670
"6:107124526:<DEL>:313:769.92:Lumpy:SVtyper:0.312","<DEL>","6",107124526,313,"intergenic",0,"Human",0.50212766,107124839
"3:123236751:<DEL>:315:2530.19:Lumpy:SVtyper:0.779","<DEL>","3",123236751,315,NA,0,"Human",0.808510638,123237066
"2:109309217:<DEL>:277:363.78:Lumpy:SVtyper:0.004","<DEL>","2",109309217,277,"intergenic",0,"Human",0.008510638,109309494
"10:123489185:<DEL>:314:582.085:Lumpy:SVtyper:0.192","<DEL>","10",123489185,314,"intergenic",0,"Human",0.319148936,123489499
"1:34568005:<DEL>:325:1198.70:Lumpy:SVtyper:0.004","<DEL>","1",34568005,325,NA,0,"Human",0.004255319,34568330
"4:181549429:<DEL>:314:820.34:Lumpy:SVtyper:0.565","<DEL>","4",181549429,314,"intergenic",0,"Human",0.74893617,181549743
"4:3748224:<DEL>:283:718.94:Lumpy:SVtyper:0.004","<DEL>","4",3748224,283,"intergenic",0,"Human",0.008510638,3748507
"X:17520622:<DEL>:315:619.27:Lumpy:SVtyper:0.522","<DEL>","X",17520622,315,NA,0,"Human",0.65106383,17520937
"10:98537150:<DEL>:308:665.415:Lumpy:SVtyper:0.065","<DEL>","10",98537150,308,"intergenic",0,"Human",0.131914894,98537458
"X:43669199:<DEL>:322:832.835:Lumpy:SVtyper:0.005","<DEL>","X",43669199,322,NA,0,"Human",0.008510638,43669521
"13:55941181:<DEL>:290:1665.59:Lumpy:SVtyper:0.692","<DEL>","13",55941181,290,"intergenic",0,"Human",0.944680851,55941471
"3:116275279:<DEL>:324:1665.33:Lumpy:SVtyper:0.014","<DEL>","3",116275279,324,"intergenic",0,"Human",0.012765957,116275603
"3:190290640:<DEL>:297:531.79:Lumpy:SVtyper:0.004","<DEL>","3",190290640,297,NA,0,"Human",0.008510638,190290937
"18:45996153:<DEL>:317:1405.945:Lumpy:SVtyper:0.822","<DEL>","18",45996153,317,"intergenic",0,"Human",0.876595745,45996470
"1:119558772:<DEL>:319:560.10:Lumpy:SVtyper:0.007","<DEL>","1",119558772,319,"intergenic",0,"Human",0.008510638,119559091
"4:181918173:<DEL>:322:588.695:Lumpy:SVtyper:0.004","<DEL>","4",181918173,322,"intergenic",0,"Human",0.008510638,181918495
"16:88900727:<DEL>:284:367.025:Lumpy:SVtyper:0.047","<DEL>","16",88900727,284,NA,0,"Human",0.080851064,88901011
"17:6874733:<DEL>:302:211.14:Lumpy:SVtyper:0.293","<DEL>","17",6874733,302,"intergenic",0,"Human",0.485106383,6875035
"11:134400090:<DEL>:303:332.24:Lumpy:SVtyper:0.145","<DEL>","11",134400090,303,"intergenic",0,"Human",0.212765957,134400393
"10:74798372:<DEL>:312:813.87:Lumpy:SVtyper:0.051","<DEL>","10",74798372,312,NA,0,"Human",0.089361702,74798684
"6:74156163:<DEL>:325:2059.67:Lumpy:SVtyper:0.011","<DEL>","6",74156163,325,NA,0,"Human",0.012765957,74156488
"2:221945359:<DEL>:304:585.715:Lumpy:SVtyper:0.004","<DEL>","2",221945359,304,"intergenic",0,"Human",0.008510638,221945663
"8:89392208:<DEL>:307:1367.53:Lumpy:SVtyper:0.014","<DEL>","8",89392208,307,"intergenic",0,"Human",0.012765957,89392515
"1:6065101:<DEL>:278:164.9:Lumpy:SVtyper:0.025","<DEL>","1",6065101,278,NA,0,"Human",0.046808511,6065379
"4:3648405:<DEL>:298:646.66:Lumpy:SVtyper:0.004","<DEL>","4",3648405,298,"intergenic",0,"Human",0.008510638,3648703
"20:36177220:<DEL>:322:715.18:Lumpy:SVtyper:0.036","<DEL>","20",36177220,322,"intergenic",0,"Human",0.080851064,36177542
"10:54441197:<DEL>:317:1512.87:Lumpy:SVtyper:0.036","<DEL>","10",54441197,317,"intergenic",0,"Human",0.076595745,54441514
"6:170206136:<DEL>:282:653.95:Lumpy:SVtyper:0.007","<DEL>","6",170206136,282,"intergenic",0,"Human",0.017021277,170206418
"1:95690513:<DEL>:319:1258.44:Lumpy:SVtyper:0.007","<DEL>","1",95690513,319,NA,0,"Human",0.012765957,95690832
"4:163232412:<DEL>:309:666.35:Lumpy:SVtyper:0.083","<DEL>","4",163232412,309,"intergenic",0,"Human",0.161702128,163232721
"6:11444346:<DEL>:313:439.29:Lumpy:SVtyper:0.101","<DEL>","6",11444346,313,"intergenic",0,"Human",0.191489362,11444659
"1:82963301:<DEL>:324:900.44:Lumpy:SVtyper:0.072","<DEL>","1",82963301,324,"intergenic",0,"Human",0.127659574,82963625
"3:131315178:<DEL>:323:466.80:Lumpy:SVtyper:0.072","<DEL>","3",131315178,323,NA,0,"Human",0.131914894,131315501
"6:123515066:<DEL>:315:653.40:Both:Both:0.007","<DEL>","6",123515066,315,"intergenic",0,"Human",0.012765957,123515381
"6:168890424:<DUP>:321:170.66:Lumpy:SVtyper:0.036","<DUP>","6",168890424,321,NA,0,"Human",0.085106383,168890745
"2:218695580:<DEL>:281:309.58:Lumpy:SVtyper:0.004","<DEL>","2",218695580,281,NA,0,"Human",0.004255319,218695861
"3:145931904:<DEL>:312:759.39:Lumpy:SVtyper:0.007","<DEL>","3",145931904,312,NA,0,"Human",0.017021277,145932216
"9:18751811:<DEL>:306:1674.375:Lumpy:SVtyper:0.663","<DEL>","9",18751811,306,NA,0,"Human",0.825531915,18752117
"8:121681677:<DEL>:319:909.60:Lumpy:SVtyper:0.355","<DEL>","8",121681677,319,NA,0,"Human",0.523404255,121681996
"17:6770022:<DEL>:324:505.09:Lumpy:SVtyper:0.004","<DEL>","17",6770022,324,"intergenic",0,"Human",0.008510638,6770346
"2:44783598:<DEL>:313:611.08:Lumpy:SVtyper:0.348","<DEL>","2",44783598,313,NA,0,"Human",0.655319149,44783911
"12:87289585:<DEL>:284:373.21:Lumpy:SVtyper:0.004","<DEL>","12",87289585,284,"intergenic",0,"Human",0.004255319,87289869
"2:84758449:<DEL>:293:2797.88:Lumpy:SVtyper:0.761","<DEL>","2",84758449,293,NA,0,"Human",0.804255319,84758742
"4:113469981:<DEL>:307:744.83:Lumpy:SVtyper:0.464","<DEL>","4",113469981,307,NA,0,"Human",0.668085106,113470288
"7:96813211:<DEL>:307:764.52:Lumpy:SVtyper:0.004","<DEL>","7",96813211,307,"intergenic",0,"Human",0.004255319,96813518
"3:7347016:<DEL>:306:430.93:Lumpy:SVtyper:0.446","<DEL>","3",7347016,306,NA,0,"Human",0.676595745,7347322
"2:235812270:<DEL>:311:739.98:Lumpy:SVtyper:0.062","<DEL>","2",235812270,311,"intergenic",0,"Human",0.114893617,235812581
"6:83676081:<DEL>:313:767.75:Lumpy:SVtyper:0.217","<DEL>","6",83676081,313,NA,0,"Human",0.374468085,83676394
"10:9519818:<DEL>:306:2099.14:Lumpy:SVtyper:0.819","<DEL>","10",9519818,306,"intergenic",0,"Human",0.842553191,9520124
"9:132306422:<DUP>:307:188.92:Lumpy:SVtyper:0.004","<DUP>","9",132306422,307,"intergenic",0,"Human",0.004255319,132306729
"7:79165331:<DEL>:310:952.89:Lumpy:SVtyper:0.047","<DEL>","7",79165331,310,"intergenic",0,"Human",0.085106383,79165641
"2:171339881:<DEL>:278:624.965:Lumpy:SVtyper:0.018","<DEL>","2",171339881,278,NA,0,"Human",0.038297872,171340159
"12:71712195:<DEL>:300:329.25:Lumpy:SVtyper:0.007","<DEL>","12",71712195,300,"intergenic",0,"Human",0.012765957,71712495
"5:173747539:<DEL>:291:153.44:Lumpy:SVtyper:0.047","<DEL>","5",173747539,291,"intergenic",0,"Human",0.089361702,173747830
"1:45092607:<DEL>:308:442.935:Lumpy:SVtyper:0.004","<DEL>","1",45092607,308,NA,0,"Human",0.008510638,45092915
"3:29620283:<DEL>:322:589.50:Lumpy:SVtyper:0.043","<DEL>","3",29620283,322,NA,0,"Human",0.080851064,29620605
"12:30009528:<DEL>:295:738.765:Lumpy:SVtyper:0.022","<DEL>","12",30009528,295,"intergenic",0,"Human",0.05106383,30009823
"16:70553012:<DEL>:320:525.32:Lumpy:SVtyper:0.011","<DEL>","16",70553012,320,NA,0,"Human",0.012765957,70553332
"6:113350499:<DEL>:278:301.63:Lumpy:SVtyper:0.004","<DEL>","6",113350499,278,"intergenic",0,"Human",0.008510638,113350777
"12:65345266:<DEL>:287:817.64:Lumpy:SVtyper:0.004","<DEL>","12",65345266,287,"intergenic",0,"Human",0.008510638,65345553
"9:78736730:<DEL>:312:1732.6:Both:Both:0.007","<DEL>","9",78736730,312,NA,0,"Human",0.008510638,78737042
"5:109297093:<DEL>:318:850.285:Lumpy:SVtyper:0.054","<DEL>","5",109297093,318,"intergenic",0,"Human",0.09787234,109297411
"15:93515791:<DEL>:313:1689.12:Lumpy:SVtyper:0.670","<DEL>","15",93515791,313,NA,0,"Human",0.787234043,93516104
"1:217917515:<DEL>:313:421.49:Both:Both:0.007","<DEL>","1",217917515,313,NA,0,"Human",0.017021277,217917828
"2:169886231:<DEL>:318:1478.63:Lumpy:SVtyper:0.094","<DEL>","2",169886231,318,NA,0,"Human",0.182978723,169886549
"11:39115475:<DEL>:325:614.85:Lumpy:SVtyper:0.054","<DEL>","11",39115475,325,"intergenic",0,"Human",0.093617021,39115800
"18:58673238:<DEL>:324:446.29:Lumpy:SVtyper:0.004","<DEL>","18",58673238,324,"intergenic",0,"Human",0.004255319,58673562
"7:39592060:<DEL>:314:555.52:Lumpy:SVtyper:0.062","<DEL>","7",39592060,314,"intergenic",0,"Human",0.085106383,39592374
"10:121154359:<DEL>:293:413.14:Lumpy:SVtyper:0.011","<DEL>","10",121154359,293,NA,0,"Human",0.021276596,121154652
"21:39900357:<DEL>:324:544.185:Lumpy:SVtyper:0.464","<DEL>","21",39900357,324,NA,0,"Human",0.672340426,39900681
"7:158896957:<DUP>:323:194.00:Lumpy:SVtyper:0.004","<DUP>","7",158896957,323,NA,0,"Human",0.004255319,158897280
"13:36438410:<DEL>:318:1041.21:Lumpy:SVtyper:0.004","<DEL>","13",36438410,318,NA,0,"Human",0.004255319,36438728
"3:131354668:<DEL>:275:103.27:Lumpy:SVtyper:0.047","<DEL>","3",131354668,275,NA,0,"Human",0.089361702,131354943
"6:9075290:<DEL>:321:775.58:Lumpy:SVtyper:0.246","<DEL>","6",9075290,321,"intergenic",0,"Human",0.408510638,9075611
"8:91069178:<DEL>:322:1085.16:Lumpy:SVtyper:0.315","<DEL>","8",91069178,322,"intergenic",0,"Human",0.514893617,91069500
"17:80649777:<DEL>:313:446.035:Lumpy:SVtyper:0.007","<DEL>","17",80649777,313,NA,0,"Human",0.017021277,80650090
"7:89598876:<DEL>:316:680.65:Lumpy:SVtyper:0.004","<DEL>","7",89598876,316,"intergenic",0,"Human",0.004255319,89599192
"18:67949601:<DEL>:325:624.155:Lumpy:SVtyper:0.413","<DEL>","18",67949601,325,"intergenic",0,"Human",0.608510638,67949926
"11:116712471:<DEL>:313:346.25:Lumpy:SVtyper:0.083","<DEL>","11",116712471,313,"intergenic",0,"Human",0.157446809,116712784
"1:101388560:<DEL>:320:632.37:Lumpy:SVtyper:0.007","<DEL>","1",101388560,320,NA,0,"Human",0.012765957,101388880
"5:24452853:<DEL>:322:1502.09:Lumpy:SVtyper:0.707","<DEL>","5",24452853,322,"intergenic",0,"Human",0.825531915,24453175
"3:172400899:<DEL>:322:691.305:Lumpy:SVtyper:0.232","<DEL>","3",172400899,322,NA,0,"Human",0.438297872,172401221
"4:663005:<DUP>:293:159.00:Lumpy:SVtyper:0.029","<DUP>","4",663005,293,NA,0,"Human",0.063829787,663298
"21:42402892:<DEL>:321:853.245:Lumpy:SVtyper:0.659","<DEL>","21",42402892,321,"intergenic",0,"Human",0.787234043,42403213
"2:172907056:<DEL>:316:1241.95:Lumpy:SVtyper:0.014","<DEL>","2",172907056,316,NA,0,"Human",0.025531915,172907372
"1:227482273:<DEL>:318:941.43:Lumpy:SVtyper:0.214","<DEL>","1",227482273,318,NA,0,"Human",0.34893617,227482591
"6:67866054:<DEL>:316:945.48:Lumpy:SVtyper:0.065","<DEL>","6",67866054,316,"intergenic",0,"Human",0.123404255,67866370
"3:82936657:<DEL>:301:598.13:Lumpy:SVtyper:0.007","<DEL>","3",82936657,301,"intergenic",0,"Human",0.012765957,82936958
"17:65727367:<DEL>:276:1952.02:Lumpy:SVtyper:0.674","<DEL>","17",65727367,276,NA,0,"Human",0.791489362,65727643
"10:107887902:<DEL>:294:1053.35:Lumpy:SVtyper:0.007","<DEL>","10",107887902,294,"intergenic",0,"Human",0.012765957,107888196
"2:25227630:<DEL>:315:692.65:Lumpy:SVtyper:0.007","<DEL>","2",25227630,315,"intergenic",0,"Human",0.021276596,25227945
"7:127766426:<DEL>:314:965.705:Lumpy:SVtyper:0.391","<DEL>","7",127766426,314,"intergenic",0,"Human",0.617021277,127766740
"1:160935025:<DEL>:316:1443.655:Lumpy:SVtyper:0.659","<DEL>","1",160935025,316,"intergenic",0,"Human",0.778723404,160935341
"3:176994731:<DEL>:296:759.94:Lumpy:SVtyper:0.025","<DEL>","3",176994731,296,"intergenic",0,"Human",0.046808511,176995027
"6:22227479:<DEL>:282:2191.505:Lumpy:SVtyper:0.797","<DEL>","6",22227479,282,"intergenic",0,"Human",0.795744681,22227761
"14:35401405:<DEL>:321:571.43:Lumpy:SVtyper:0.004","<DEL>","14",35401405,321,"intergenic",0,"Human",0.017021277,35401726
"1:24538275:<DEL>:305:1000.22:Lumpy:SVtyper:0.011","<DEL>","1",24538275,305,"intergenic",0,"Human",0.012765957,24538580
"11:16597570:<DEL>:323:916.07:Lumpy:SVtyper:0.029","<DEL>","11",16597570,323,"intergenic",0,"Human",0.063829787,16597893
"3:32203872:<DEL>:282:809.955:Lumpy:SVtyper:0.014","<DEL>","3",32203872,282,NA,0,"Human",0.025531915,32204154
"4:170808438:<DEL>:280:382.92:Lumpy:SVtyper:0.174","<DEL>","4",170808438,280,"intergenic",0,"Human",0.293617021,170808718
"8:39008204:<DEL>:283:106.77:Lumpy:SVtyper:0","<DEL>","8",39008204,283,NA,0,"Human",0.004255319,39008487
"10:413829:<DEL>:294:655.00:Lumpy:SVtyper:0.319","<DEL>","10",413829,294,NA,0,"Human",0.540425532,414123
"16:49979401:<DEL>:314:535.02:Lumpy:SVtyper:0.007","<DEL>","16",49979401,314,"intergenic",0,"Human",0.012765957,49979715
"18:32661963:<DEL>:317:860.66:Lumpy:SVtyper:0.004","<DEL>","18",32661963,317,NA,0,"Human",0.004255319,32662280
"13:65870887:<DEL>:304:1207.68:Lumpy:SVtyper:0.007","<DEL>","13",65870887,304,"intergenic",0,"Human",0.012765957,65871191
"3:99785352:<DEL>:306:561.17:Lumpy:SVtyper:0.004","<DEL>","3",99785352,306,NA,0,"Human",0.008510638,99785658
"4:102391530:<DEL>:298:421.22:Lumpy:SVtyper:0.025","<DEL>","4",102391530,298,"intergenic",0,"Human",0.05106383,102391828
"4:5834886:<DEL>:313:450.89:Lumpy:SVtyper:0.152","<DEL>","4",5834886,313,NA,0,"Human",0.285106383,5835199
"9:95634507:<DEL>:319:440.635:Lumpy:SVtyper:0.163","<DEL>","9",95634507,319,NA,0,"Human",0.30212766,95634826
"10:91809916:<DEL>:310:689.545:Lumpy:SVtyper:0.159","<DEL>","10",91809916,310,"intergenic",0,"Human",0.280851064,91810226
"2:82340457:<DEL>:320:474.61:Lumpy:SVtyper:0.007","<DEL>","2",82340457,320,"intergenic",0,"Human",0.012765957,82340777
"X:75253861:<DEL>:310:347.61:Lumpy:SVtyper:0.242","<DEL>","X",75253861,310,"intergenic",0,"Human",0.361702128,75254171
"12:129840690:<DEL>:313:663.525:Lumpy:SVtyper:0.402","<DEL>","12",129840690,313,NA,0,"Human",0.612765957,129841003
"6:163693918:<DEL>:310:728.52:Lumpy:SVtyper:0.004","<DEL>","6",163693918,310,NA,0,"Human",0.008510638,163694228
"4:109107678:<DEL>:301:391.02:Lumpy:SVtyper:0.004","<DEL>","4",109107678,301,"intergenic",0,"Human",0.012765957,109107979
"6:129737083:<DEL>:314:516.96:Lumpy:SVtyper:0.004","<DEL>","6",129737083,314,NA,0,"Human",0.008510638,129737397
"17:44223913:<DEL>:314:1645.27:Lumpy:SVtyper:0.152","<DEL>","17",44223913,314,NA,0,"Human",0.276595745,44224227
"6:11444350:<DEL>:312:865.10:Lumpy:SVtyper:0.007","<DEL>","6",11444350,312,"intergenic",0,"Human",0.008510638,11444662
"X:85878766:<DEL>:320:932.48:Lumpy:SVtyper:0.087","<DEL>","X",85878766,320,NA,0,"Human",0.136170213,85879086
"9:114902348:<DEL>:315:374.7:Lumpy:SVtyper:0.130","<DEL>","9",114902348,315,NA,0,"Human",0.238297872,114902663
"10:10493410:<DEL>:323:565.49:Lumpy:SVtyper:0.004","<DEL>","10",10493410,323,"intergenic",0,"Human",0.004255319,10493733
"2:10837642:<DEL>:322:744.84:Lumpy:SVtyper:0.004","<DEL>","2",10837642,322,"intergenic",0,"Human",0.008510638,10837964
"X:152857290:<DEL>:316:1778.36:Lumpy:Both:0.005","<DEL>","X",152857290,316,NA,0,"Human",0.004255319,152857606
"18:77365903:<DEL>:302:144.535:Lumpy:SVtyper:0.011","<DEL>","18",77365903,302,"intergenic",0,"Human",0.021276596,77366205
"2:242756394:<DEL>:313:209.80:Lumpy:SVtyper:0.004","<DEL>","2",242756394,313,NA,0,"Human",0.004255319,242756707
"3:99785352:<DEL>:306:642.615:Lumpy:SVtyper:0.145","<DEL>","3",99785352,306,NA,0,"Human",0.280851064,99785658
"5:82482759:<DEL>:306:774.50:Lumpy:SVtyper:0.275","<DEL>","5",82482759,306,NA,0,"Human",0.417021277,82483065
"3:149878068:<DEL>:308:707.07:Lumpy:SVtyper:0.373","<DEL>","3",149878068,308,"intergenic",0,"Human",0.655319149,149878376
"15:24839321:<DEL>:319:693.32:Lumpy:SVtyper:0.214","<DEL>","15",24839321,319,"intergenic",0,"Human",0.374468085,24839640
"1:162052671:<DEL>:320:3302.67:Lumpy:SVtyper:0.790","<DEL>","1",162052671,320,NA,0,"Human",0.868085106,162052991
"2:161795605:<DEL>:324:3214.73:Lumpy:SVtyper:0.822","<DEL>","2",161795605,324,"intergenic",0,"Human",0.829787234,161795929
"20:39886334:<DEL>:288:143.72:Lumpy:SVtyper:0.036","<DEL>","20",39886334,288,NA,0,"Human",0.085106383,39886622
"4:157002035:<DEL>:311:815.75:Lumpy:SVtyper:0.029","<DEL>","4",157002035,311,"intergenic",0,"Human",0.038297872,157002346
"20:11517266:<DEL>:323:512.365:Lumpy:SVtyper:0.018","<DEL>","20",11517266,323,"intergenic",0,"Human",0.025531915,11517589
"1:82963301:<DEL>:324:1214.35:Lumpy:SVtyper:0.228","<DEL>","1",82963301,324,"intergenic",0,"Human",0.4,82963625
"21:45839406:<DUP>:316:346.23:Lumpy:SVtyper:0.355","<DUP>","21",45839406,316,NA,0,"Human",0.69787234,45839722
"10:59296699:<DEL>:317:614.85:Lumpy:SVtyper:0.094","<DEL>","10",59296699,317,"intergenic",0,"Human",0.170212766,59297016
"5:173607101:<DEL>:320:341.94:Lumpy:SVtyper:0.051","<DEL>","5",173607101,320,"intergenic",0,"Human",0.093617021,173607421
"8:16962211:<DEL>:318:831.81:Lumpy:SVtyper:0.384","<DEL>","8",16962211,318,NA,0,"Human",0.595744681,16962529
"9:112824013:<DEL>:305:523.42:Lumpy:SVtyper:0.018","<DEL>","9",112824013,305,NA,0,"Human",0.034042553,112824318
"2:160855855:<DEL>:323:736.20:Lumpy:SVtyper:0.007","<DEL>","2",160855855,323,NA,0,"Human",0.012765957,160856178
"16:58290906:<DEL>:318:306.875:Lumpy:SVtyper:0.004","<DEL>","16",58290906,318,NA,0,"Human",0.004255319,58291224
"11:105765515:<DEL>:319:398.83:Lumpy:SVtyper:0.185","<DEL>","11",105765515,319,NA,0,"Human",0.310638298,105765834
"6:116750811:<DEL>:322:2823.70:Lumpy:SVtyper:0.576","<DEL>","6",116750811,322,NA,0,"Human",0.774468085,116751133
"5:115894133:<DEL>:325:1533.90:Lumpy:SVtyper:0.652","<DEL>","5",115894133,325,NA,0,"Human",0.859574468,115894458
"3:571755:<DEL>:325:987.005:Lumpy:SVtyper:0.014","<DEL>","3",571755,325,"intergenic",0,"Human",0.025531915,572080
"2:233668372:<DEL>:305:408.675:Both:Both:0.007","<DEL>","2",233668372,305,NA,0,"Human",0.012765957,233668677
"5:122274355:<DEL>:323:1015.325:Lumpy:SVtyper:0.580","<DEL>","5",122274355,323,NA,0,"Human",0.740425532,122274678
"4:263926:<DEL>:325:912.84:Lumpy:SVtyper:0.040","<DEL>","4",263926,325,NA,0,"Human",0.076595745,264251
"3:190290640:<DEL>:297:678.62:Lumpy:SVtyper:0.011","<DEL>","3",190290640,297,NA,0,"Human",0.012765957,190290937
"11:101290001:<DEL>:324:468.96:Lumpy:SVtyper:0.156","<DEL>","11",101290001,324,"intergenic",0,"Human",0.30212766,101290325
"21:30234675:<DEL>:310:1287.96:Lumpy:SVtyper:0.004","<DEL>","21",30234675,310,"intergenic",0,"Human",0.008510638,30234985
"7:75868188:<DUP>:325:537.12:Lumpy:SVtyper:0.025","<DUP>","7",75868188,325,NA,0,"Human",0.042553191,75868513
"1:182215403:<DUP>:307:363.35:Lumpy:SVtyper:0.004","<DUP>","1",182215403,307,"intergenic",0,"Human",0.008510638,182215710
"9:9134051:<DEL>:322:1228.09:Lumpy:SVtyper:0.022","<DEL>","9",9134051,322,NA,0,"Human",0.042553191,9134373
"21:35150870:<DEL>:318:448.195:Lumpy:SVtyper:0.007","<DEL>","21",35150870,318,NA,0,"Human",0.008510638,35151188
"14:52594673:<DEL>:315:1066.16:Lumpy:SVtyper:0.065","<DEL>","14",52594673,315,"intergenic",0,"Human",0.106382979,52594988
"13:103931651:<DEL>:315:751.57:Lumpy:SVtyper:0.344","<DEL>","13",103931651,315,"intergenic",0,"Human",0.544680851,103931966
"10:107677555:<DEL>:325:999.95:Lumpy:SVtyper:0.138","<DEL>","10",107677555,325,"intergenic",0,"Human",0.217021277,107677880
"X:135372590:<DUP>:311:221.10:Lumpy:SVtyper:0.029","<DUP>","X",135372590,311,"intergenic",0,"Human",0.046808511,135372901
"16:20778542:<DEL>:319:780.3:Lumpy:SVtyper:0.558","<DEL>","16",20778542,319,NA,0,"Human",0.719148936,20778861
"12:84484487:<DEL>:316:326.42:Both:Both:0.007","<DEL>","12",84484487,316,"intergenic",0,"Human",0.021276596,84484803
"9:124496366:<DEL>:316:378.88:Lumpy:SVtyper:0.007","<DEL>","9",124496366,316,NA,0,"Human",0.008510638,124496682
"11:64363467:<DUP>:308:120.8:Lumpy:SVtyper:0.308","<DUP>","11",64363467,308,NA,0,"Human",0.6,64363775
"2:202721652:<DEL>:321:496.735:Lumpy:SVtyper:0.293","<DEL>","2",202721652,321,NA,0,"Human",0.463829787,202721973
"22:33295767:<DEL>:318:944.39:Lumpy:SVtyper:0.007","<DEL>","22",33295767,318,NA,0,"Human",0.012765957,33296085
"17:5933607:<DEL>:317:314.96:Lumpy:SVtyper:0.007","<DEL>","17",5933607,317,"intergenic",0,"Human",0.012765957,5933924
"6:425835:<DEL>:304:607.30:Lumpy:SVtyper:0.014","<DEL>","6",425835,304,"intergenic",0,"Human",0.017021277,426139
"5:81242263:<DEL>:319:387.775:Lumpy:SVtyper:0.007","<DEL>","5",81242263,319,"intergenic",0,"Human",0.012765957,81242582
"8:56401211:<DEL>:316:1757.71:Lumpy:SVtyper:0.572","<DEL>","8",56401211,316,NA,0,"Human",0.727659574,56401527
"8:52061006:<DEL>:311:388.59:Lumpy:SVtyper:0.007","<DEL>","8",52061006,311,"intergenic",0,"Human",0.008510638,52061317
"11:88298002:<DEL>:303:1587.02:Lumpy:SVtyper:0.011","<DEL>","11",88298002,303,NA,0,"Human",0.025531915,88298305
"8:1056458:<DEL>:292:430.12:Lumpy:SVtyper:0.004","<DEL>","8",1056458,292,"intergenic",0,"Human",0.004255319,1056750
"6:32593703:<DEL>:314:1252.34:Lumpy:SVtyper:0.482","<DEL>","6",32593703,314,"intergenic",0,"Human",0.757446809,32594017
"4:90338812:<DEL>:294:434.15:Lumpy:SVtyper:0.004","<DEL>","4",90338812,294,"intergenic",0,"Human",0.004255319,90339106
"2:160855855:<DEL>:323:824.79:Lumpy:SVtyper:0.714","<DEL>","2",160855855,323,NA,0,"Human",0.846808511,160856178
"17:72803364:<DEL>:319:523.97:Lumpy:SVtyper:0.004","<DEL>","17",72803364,319,NA,0,"Human",0.008510638,72803683
"5:143488148:<DUP>:290:472.155:Lumpy:SVtyper:0.014","<DUP>","5",143488148,290,"intergenic",0,"Human",0.025531915,143488438
"11:107733015:<DEL>:318:177.305:Lumpy:SVtyper:0.004","<DEL>","11",107733015,318,"intergenic",0,"Human",0.004255319,107733333
"12:126905107:<DEL>:314:396.14:Lumpy:SVtyper:0.007","<DEL>","12",126905107,314,"intergenic",0,"Human",0.017021277,126905421
"2:213574683:<DEL>:306:1065.20:Lumpy:SVtyper:0.004","<DEL>","2",213574683,306,"intergenic",0,"Human",0.008510638,213574989
"7:107410468:<DEL>:307:914.46:Lumpy:SVtyper:0.004","<DEL>","7",107410468,307,NA,0,"Human",0.008510638,107410775
"1:232775531:<DEL>:314:1147.195:Lumpy:SVtyper:0.341","<DEL>","1",232775531,314,"intergenic",0,"Human",0.54893617,232775845
"10:9519818:<DEL>:306:2722.28:Lumpy:SVtyper:0.007","<DEL>","10",9519818,306,"intergenic",0,"Human",0.012765957,9520124
"1:210295310:<DEL>:319:899.91:Lumpy:SVtyper:0.453","<DEL>","1",210295310,319,NA,0,"Human",0.638297872,210295629
"16:89133161:<DEL>:277:613.24:Lumpy:SVtyper:0.004","<DEL>","16",89133161,277,"intergenic",0,"Human",0.008510638,89133438
"6:41404064:<DEL>:323:620.92:Lumpy:SVtyper:0.449","<DEL>","6",41404064,323,"intergenic",0,"Human",0.659574468,41404387
"15:67083772:<DEL>:298:881.28:Lumpy:SVtyper:0.279","<DEL>","15",67083772,298,"intergenic",0,"Human",0.434042553,67084070
"17:75988287:<DEL>:310:3471.145:Lumpy:SVtyper:0.261","<DEL>","17",75988287,310,"intergenic",0,"Human",0.434042553,75988597
"8:126284873:<DEL>:298:693.32:Lumpy:SVtyper:0.065","<DEL>","8",126284873,298,NA,0,"Human",0.123404255,126285171
"18:31143928:<DEL>:318:1100.135:Both:Both:0.004","<DEL>","18",31143928,318,"intergenic",0,"Human",0.008510638,31144246
"13:25721018:<DEL>:319:1396.73:Lumpy:SVtyper:0.678","<DEL>","13",25721018,319,"intergenic",0,"Human",0.817021277,25721337
"5:62704439:<DEL>:323:463.55:Both:Both:0.007","<DEL>","5",62704439,323,"intergenic",0,"Human",0.012765957,62704762
"5:99608162:<DEL>:313:225.17:Lumpy:SVtyper:0.011","<DEL>","5",99608162,313,"intergenic",0,"Human",0.012765957,99608475
"12:4088893:<DUP>:295:437.02:Lumpy:SVtyper:0.004","<DUP>","12",4088893,295,"intergenic",0,"Human",0.004255319,4089188
"1:119558772:<DEL>:319:1188.18:Lumpy:SVtyper:0.156","<DEL>","1",119558772,319,"intergenic",0,"Human",0.280851064,119559091
"20:48917454:<DEL>:281:199.95:Lumpy:SVtyper:0.004","<DEL>","20",48917454,281,"intergenic",0,"Human",0.008510638,48917735
"10:70998111:<DEL>:324:3263.585:Lumpy:SVtyper:0.449","<DEL>","10",70998111,324,NA,0,"Human",0.629787234,70998435
"5:99174316:<DEL>:314:1679.91:Lumpy:SVtyper:0.529","<DEL>","5",99174316,314,"intergenic",0,"Human",0.744680851,99174630
"3:86213404:<DEL>:317:953.02:Lumpy:SVtyper:0.279","<DEL>","3",86213404,317,"intergenic",0,"Human",0.523404255,86213721
"19:37460951:<DEL>:322:232.72:Lumpy:SVtyper:0.007","<DEL>","19",37460951,322,NA,0,"Human",0.008510638,37461273
"4:122234575:<DEL>:322:809.55:Lumpy:SVtyper:0.004","<DEL>","4",122234575,322,"intergenic",0,"Human",0.004255319,122234897
"5:25833352:<DEL>:298:727.04:Lumpy:SVtyper:0.116","<DEL>","5",25833352,298,"intergenic",0,"Human",0.2,25833650
"9:122531837:<DEL>:318:1539.18:Lumpy:SVtyper:0.007","<DEL>","9",122531837,318,"intergenic",0,"Human",0.012765957,122532155
"13:64448586:<DEL>:314:239.73:Lumpy:SVtyper:0.004","<DEL>","13",64448586,314,"intergenic",0,"Human",0.004255319,64448900
"6:140952903:<DEL>:288:741.86:Lumpy:SVtyper:0.007","<DEL>","6",140952903,288,"intergenic",0,"Human",0.008510638,140953191
"14:77674630:<DEL>:288:355.15:Lumpy:SVtyper:0.004","<DEL>","14",77674630,288,NA,0,"Human",0.004255319,77674918
"2:2648599:<DEL>:315:146.29:Lumpy:SVtyper:0.004","<DEL>","2",2648599,315,"intergenic",0,"Human",0.004255319,2648914
"16:89799034:<DEL>:299:350.975:Lumpy:SVtyper:0.138","<DEL>","16",89799034,299,NA,0,"Human",0.255319149,89799333
"21:40881873:<DEL>:304:697.10:Lumpy:SVtyper:0.029","<DEL>","21",40881873,304,NA,0,"Human",0.063829787,40882177
"1:11682894:<DEL>:296:969.21:Both:Both:0.656","<DEL>","1",11682894,296,"intergenic",0,"Human",0.910638298,11683190
"17:56463444:<DEL>:317:501.85:Lumpy:SVtyper:0.004","<DEL>","17",56463444,317,NA,0,"Human",0.004255319,56463761
"10:55958257:<DEL>:291:356.24:Lumpy:SVtyper:0.091","<DEL>","10",55958257,291,NA,0,"Human",0.14893617,55958548
"11:114831634:<DEL>:285:522.89:Lumpy:SVtyper:0.004","<DEL>","11",114831634,285,"intergenic",0,"Human",0.004255319,114831919
"5:125105613:<DEL>:282:530.305:Lumpy:SVtyper:0.007","<DEL>","5",125105613,282,"intergenic",0,"Human",0.021276596,125105895
"8:132168284:<DEL>:313:643.98:Lumpy:SVtyper:0.007","<DEL>","8",132168284,313,"intergenic",0,"Human",0.017021277,132168597
"18:21911355:<DEL>:309:1142.34:Lumpy:SVtyper:0.004","<DEL>","18",21911355,309,NA,0,"Human",0.008510638,21911664
"6:22782654:<DEL>:324:1019.13:Lumpy:SVtyper:0.004","<DEL>","6",22782654,324,"intergenic",0,"Human",0.004255319,22782978
"7:27948622:<DEL>:297:523.69:Lumpy:SVtyper:0.004","<DEL>","7",27948622,297,NA,0,"Human",0.004255319,27948919
"4:16853404:<DUP>:288:512.57:Lumpy:SVtyper:0.004","<DUP>","4",16853404,288,NA,0,"Human",0.004255319,16853692
"2:46910137:<DEL>:316:1759.91:Lumpy:SVtyper:0.482","<DEL>","2",46910137,316,"intergenic",0,"Human",0.668085106,46910453
"17:58446352:<DEL>:308:851.09:Lumpy:SVtyper:0.007","<DEL>","17",58446352,308,NA,0,"Human",0.012765957,58446660
"6:124178786:<DEL>:290:946.69:Lumpy:SVtyper:0.007","<DEL>","6",124178786,290,NA,0,"Human",0.025531915,124179076
"17:73040283:<DEL>:317:265.35:Lumpy:SVtyper:0.170","<DEL>","17",73040283,317,NA,0,"Human",0.280851064,73040600
"1:29510505:<DEL>:296:187.41:Lumpy:SVtyper:0.007","<DEL>","1",29510505,296,"intergenic",0,"Human",0.008510638,29510801
"21:42402892:<DEL>:321:192.145:Lumpy:SVtyper:0.004","<DEL>","21",42402892,321,"intergenic",0,"Human",0.004255319,42403213
"5:3499272:<DEL>:321:713.825:Lumpy:SVtyper:0.007","<DEL>","5",3499272,321,"intergenic",0,"Human",0.021276596,3499593
"4:3414608:<DEL>:282:328.59:Lumpy:SVtyper:0.004","<DEL>","4",3414608,282,NA,0,"Human",0.008510638,3414890
"11:77162635:<DEL>:321:1066.56:Lumpy:SVtyper:0.029","<DEL>","11",77162635,321,NA,0,"Human",0.05106383,77162956
"5:75082303:<DEL>:309:588.42:Lumpy:SVtyper:0.257","<DEL>","5",75082303,309,"intergenic",0,"Human",0.45106383,75082612
"6:116750825:<DEL>:319:142.1:Lumpy:SVtyper:0.007","<DEL>","6",116750825,319,NA,0,"Human",0.008510638,116751144
"9:112430208:<DEL>:315:154.935:Lumpy:SVtyper:0.007","<DEL>","9",112430208,315,NA,0,"Human",0.017021277,112430523
"13:64903299:<DEL>:314:591.39:Lumpy:SVtyper:0.054","<DEL>","13",64903299,314,"intergenic",0,"Human",0.123404255,64903613
"X:37974444:<DEL>:321:513.18:Lumpy:SVtyper:0.024","<DEL>","X",37974444,321,NA,0,"Human",0.038297872,37974765
"5:35614165:<DEL>:322:1166.34:Lumpy:SVtyper:0.199","<DEL>","5",35614165,322,"intergenic",0,"Human",0.357446809,35614487
"6:12664199:<DEL>:322:777.46:Lumpy:SVtyper:0.112","<DEL>","6",12664199,322,"intergenic",0,"Human",0.221276596,12664521
"15:82382926:<DEL>:312:460.33:Both:Both:0.018","<DEL>","15",82382926,312,"intergenic",0,"Human",0.038297872,82383238
"4:3492110:<DUP>:287:181.58:Lumpy:SVtyper:0.004","<DUP>","4",3492110,287,NA,0,"Human",0.008510638,3492397
"10:78800903:<DEL>:319:217.21:Lumpy:SVtyper:0.007","<DEL>","10",78800903,319,NA,0,"Human",0.012765957,78801222
"5:78277729:<DEL>:319:133.46:Lumpy:SVtyper:0.004","<DEL>","5",78277729,319,NA,0,"Human",0.012765957,78278048
"3:186826659:<DEL>:314:970.55:Lumpy:SVtyper:0.004","<DEL>","3",186826659,314,"intergenic",0,"Human",0.008510638,186826973
"6:159652114:<DEL>:313:1589.445:Lumpy:SVtyper:0.594","<DEL>","6",159652114,313,NA,0,"Human",0.740425532,159652427
"17:67087662:<DEL>:311:2006.40:Lumpy:SVtyper:0.500","<DEL>","17",67087662,311,NA,0,"Human",0.727659574,67087973
"4:93393065:<DEL>:320:885.87:Lumpy:SVtyper:0.286","<DEL>","4",93393065,320,NA,0,"Human",0.463829787,93393385
"5:117868223:<DEL>:312:734.85:Lumpy:SVtyper:0.156","<DEL>","5",117868223,312,"intergenic",0,"Human",0.285106383,117868535
"6:144453351:<DEL>:294:302.57:Lumpy:SVtyper:0.054","<DEL>","6",144453351,294,"intergenic",0,"Human",0.106382979,144453645
"1:80218095:<DEL>:316:845.96:Lumpy:SVtyper:0.004","<DEL>","1",80218095,316,"intergenic",0,"Human",0.012765957,80218411
"4:86660760:<DEL>:322:2471.005:Lumpy:SVtyper:0.812","<DEL>","4",86660760,322,NA,0,"Human",0.834042553,86661082
"2:134888150:<DEL>:319:312.26:Lumpy:SVtyper:0","<DEL>","2",134888150,319,"intergenic",0,"Human",0.004255319,134888469
"1:180292996:<DEL>:325:2063.40:Lumpy:SVtyper:0.801","<DEL>","1",180292996,325,NA,0,"Human",0.829787234,180293321
"17:85295:<DEL>:300:112.98:Lumpy:SVtyper:0.007","<DEL>","17",85295,300,NA,0,"Human",0.017021277,85595
"13:101906948:<DEL>:315:795.54:Lumpy:SVtyper:0.250","<DEL>","13",101906948,315,NA,0,"Human",0.434042553,101907263
"2:240838456:<DEL>:291:607.58:Lumpy:SVtyper:0.094","<DEL>","2",240838456,291,"intergenic",0,"Human",0.136170213,240838747
"17:10592145:<DEL>:316:519.39:Lumpy:SVtyper:0.004","<DEL>","17",10592145,316,NA,0,"Human",0.004255319,10592461
"3:141384743:<DEL>:292:461.415:Lumpy:SVtyper:0.014","<DEL>","3",141384743,292,"intergenic",0,"Human",0.012765957,141385035
"19:23320789:<DEL>:317:1065.75:Lumpy:SVtyper:0.014","<DEL>","19",23320789,317,NA,0,"Human",0.012765957,23321106
"12:129795501:<DEL>:281:1242.39:Lumpy:SVtyper:0.159","<DEL>","12",129795501,281,NA,0,"Human",0.310638298,129795782
"16:72753297:<DEL>:305:564.015:Lumpy:SVtyper:0.007","<DEL>","16",72753297,305,"intergenic",0,"Human",0.012765957,72753602
"7:24677926:<DEL>:323:740.52:Lumpy:SVtyper:0.308","<DEL>","7",24677926,323,NA,0,"Human",0.468085106,24678249
"5:7372364:<DUP>:282:466.94:Lumpy:SVtyper:0.007","<DUP>","5",7372364,282,"intergenic",0,"Human",0.012765957,7372646
"12:1864013:<DEL>:315:247.01:Lumpy:SVtyper:0.004","<DEL>","12",1864013,315,NA,0,"Human",0.008510638,1864328
"10:100496980:<DEL>:308:329.54:Lumpy:SVtyper:0.221","<DEL>","10",100496980,308,NA,0,"Human",0.395744681,100497288
"18:69829577:<DEL>:314:405.04:Lumpy:SVtyper:0.004","<DEL>","18",69829577,314,"intergenic",0,"Human",0.008510638,69829891
"2:34643633:<DEL>:307:752.795:Lumpy:SVtyper:0.471","<DEL>","2",34643633,307,"intergenic",0,"Human",0.655319149,34643940
"7:123187787:<DEL>:284:370.78:Lumpy:Both:0.004","<DEL>","7",123187787,284,NA,0,"Human",0.004255319,123188071
"4:263969:<DEL>:281:999.28:Lumpy:SVtyper:0.149","<DEL>","4",263969,281,NA,0,"Human",0.259574468,264250
"12:77908657:<DEL>:323:2411.08:Lumpy:SVtyper:0.315","<DEL>","12",77908657,323,"intergenic",0,"Human",0.527659574,77908980
"19:33572752:<DEL>:293:419.59:Lumpy:SVtyper:0.156","<DEL>","19",33572752,293,NA,0,"Human",0.255319149,33573045
"4:161034246:<DEL>:284:1313.58:Lumpy:SVtyper:0.275","<DEL>","4",161034246,284,"intergenic",0,"Human",0.455319149,161034530
"17:51742356:<DUP>:295:808.18:Lumpy:SVtyper:0.007","<DUP>","17",51742356,295,"intergenic",0,"Human",0.012765957,51742651
"18:19232944:<DEL>:277:445.355:Lumpy:SVtyper:0.004","<DEL>","18",19232944,277,NA,0,"Human",0.008510638,19233221
"1:43008204:<DEL>:323:512.635:Lumpy:SVtyper:0.007","<DEL>","1",43008204,323,NA,0,"Human",0.008510638,43008527
"7:70567076:<DEL>:325:692.375:Lumpy:SVtyper:0.007","<DEL>","7",70567076,325,"intergenic",0,"Human",0.008510638,70567401
"5:45987448:<DUP>:322:322.52:Lumpy:SVtyper:0.004","<DUP>","5",45987448,322,"intergenic",0,"Human",0.004255319,45987770
"3:185017329:<DEL>:325:1208.95:Lumpy:SVtyper:0.674","<DEL>","3",185017329,325,NA,0,"Human",0.795744681,185017654
"8:141084308:<DUP>:277:229.37:Lumpy:SVtyper:0.004","<DUP>","8",141084308,277,NA,0,"Human",0.012765957,141084585
"12:84042278:<DEL>:313:1278.53:Lumpy:SVtyper:0.417","<DEL>","12",84042278,313,"intergenic",0,"Human",0.629787234,84042591
"4:2338396:<DUP>:322:168.83:Lumpy:SVtyper:0.072","<DUP>","4",2338396,322,NA,0,"Human",0.161702128,2338718
"18:70978851:<DEL>:315:462.21:Lumpy:SVtyper:0.236","<DEL>","18",70978851,315,"intergenic",0,"Human",0.408510638,70979166
"11:19555240:<DEL>:312:809.55:Lumpy:SVtyper:0.004","<DEL>","11",19555240,312,NA,0,"Human",0.004255319,19555552
"5:141459201:<DEL>:305:547.16:Lumpy:SVtyper:0.333","<DEL>","5",141459201,305,"intergenic",0,"Human",0.561702128,141459506
"5:3327308:<DEL>:322:1321.41:Lumpy:SVtyper:0.018","<DEL>","5",3327308,322,"intergenic",0,"Human",0.038297872,3327630
"14:103583518:<DEL>:319:530.45:Lumpy:SVtyper:0.007","<DEL>","14",103583518,319,"intergenic",0,"Human",0.017021277,103583837
"9:83630440:<DEL>:313:657.6:Lumpy:SVtyper:0.681","<DEL>","9",83630440,313,"intergenic",0,"Human",0.778723404,83630753
"2:163666414:<DEL>:315:2588.45:Lumpy:SVtyper:0.529","<DEL>","2",163666414,315,NA,0,"Human",0.736170213,163666729
"5:75082303:<DEL>:309:139.13:Lumpy:SVtyper:0","<DEL>","5",75082303,309,"intergenic",0,"Human",0.008510638,75082612
"7:108352852:<DEL>:325:1048.76:Lumpy:SVtyper:0.438","<DEL>","7",108352852,325,"intergenic",0,"Human",0.638297872,108353177
"17:2851736:<DEL>:300:288.00:Lumpy:SVtyper:0.007","<DEL>","17",2851736,300,NA,0,"Human",0.017021277,2852036
"X:114670497:<DEL>:295:773.685:Lumpy:SVtyper:0.184","<DEL>","X",114670497,295,"intergenic",0,"Human",0.225531915,114670792
"12:84484487:<DEL>:316:1012.08:Lumpy:SVtyper:0.659","<DEL>","12",84484487,316,"intergenic",0,"Human",0.8,84484803
"18:75084748:<DEL>:300:337.35:Lumpy:SVtyper:0.007","<DEL>","18",75084748,300,"intergenic",0,"Human",0.008510638,75085048
"1:94251463:<DEL>:313:575.885:Lumpy:SVtyper:0.065","<DEL>","1",94251463,313,NA,0,"Human",0.123404255,94251776
"4:186198866:<DEL>:319:416.23:Lumpy:SVtyper:0.004","<DEL>","4",186198866,319,NA,0,"Human",0.008510638,186199185
"2:56083531:<DEL>:317:1252.825:Lumpy:SVtyper:0.014","<DEL>","2",56083531,317,"intergenic",0,"Human",0.012765957,56083848
"6:1682794:<DEL>:311:1681.555:Lumpy:SVtyper:0.217","<DEL>","6",1682794,311,NA,0,"Human",0.293617021,1683105
"6:44613495:<DEL>:316:314.96:Lumpy:SVtyper:0.004","<DEL>","6",44613495,316,"intergenic",0,"Human",0.004255319,44613811
"10:10708538:<DEL>:317:1031.22:Lumpy:SVtyper:0.004","<DEL>","10",10708538,317,"intergenic",0,"Human",0.004255319,10708855
"10:30547844:<DEL>:313:996.45:Lumpy:SVtyper:0.014","<DEL>","10",30547844,313,"intergenic",0,"Human",0.038297872,30548157
"17:73433598:<DUP>:280:600.725:Lumpy:SVtyper:0.047","<DUP>","17",73433598,280,"intergenic",0,"Human",0.093617021,73433878
"13:70459059:<DEL>:314:809.01:Lumpy:SVtyper:0.007","<DEL>","13",70459059,314,NA,0,"Human",0.012765957,70459373
"20:62123517:<DUP>:318:819.5:Lumpy:SVtyper:0.087","<DUP>","20",62123517,318,NA,0,"Human",0.114893617,62123835
"19:13479557:<DEL>:320:660.695:Lumpy:SVtyper:0.025","<DEL>","19",13479557,320,NA,0,"Human",0.063829787,13479877
"7:116842004:<DEL>:311:2276.675:Lumpy:SVtyper:0.091","<DEL>","7",116842004,311,NA,0,"Human",0.127659574,116842315
"4:44509387:<DEL>:318:2862.39:Lumpy:SVtyper:0.830","<DEL>","4",44509387,318,"intergenic",0,"Human",0.863829787,44509705
"19:49947388:<DEL>:311:316.31:Lumpy:SVtyper:0","<DEL>","19",49947388,311,"intergenic",0,"Human",0.004255319,49947699
"5:53176934:<DEL>:305:122.68:Lumpy:SVtyper:0.004","<DEL>","5",53176934,305,"intergenic",0,"Human",0.008510638,53177239
"13:110874829:<DEL>:314:771.53:Lumpy:SVtyper:0.036","<DEL>","13",110874829,314,NA,0,"Human",0.068085106,110875143
"2:121782126:<DEL>:295:970.30:Lumpy:SVtyper:0.007","<DEL>","2",121782126,295,"intergenic",0,"Human",0.012765957,121782421
"9:18751837:<DEL>:290:904.75:Lumpy:SVtyper:0.007","<DEL>","9",18751837,290,NA,0,"Human",0.012765957,18752127
"13:23055207:<DEL>:308:2209.46:Lumpy:SVtyper:0.591","<DEL>","13",23055207,308,"intergenic",0,"Human",0.795744681,23055515
"5:151894954:<DEL>:297:437.67:Lumpy:SVtyper:0.004","<DEL>","5",151894954,297,"intergenic",0,"Human",0.008510638,151895251
"4:190291419:<DEL>:319:650.705:Lumpy:SVtyper:0.018","<DEL>","4",190291419,319,"intergenic",0,"Human",0.025531915,190291738
"19:20176722:<DEL>:310:501.315:Lumpy:SVtyper:0.159","<DEL>","19",20176722,310,"intergenic",0,"Human",0.306382979,20177032
"6:10070793:<DEL>:313:111.09:Lumpy:SVtyper:0.007","<DEL>","6",10070793,313,"intergenic",0,"Human",0.017021277,10071106
"2:150759304:<DEL>:321:393.18:Lumpy:SVtyper:0.569","<DEL>","2",150759304,321,"intergenic",0,"Human",0.740425532,150759625
"5:128378682:<DEL>:311:864.975:Lumpy:SVtyper:0.250","<DEL>","5",128378682,311,"intergenic",0,"Human",0.421276596,128378993
"2:85326976:<DEL>:307:1193.32:Lumpy:SVtyper:0.351","<DEL>","2",85326976,307,"intergenic",0,"Human",0.557446809,85327283
"20:54463223:<DEL>:317:735.39:Lumpy:SVtyper:0.011","<DEL>","20",54463223,317,"intergenic",0,"Human",0.012765957,54463540
"X:116954965:<DEL>:323:569.955:Lumpy:SVtyper:0.014","<DEL>","X",116954965,323,"intergenic",0,"Human",0.017021277,116955288
"16:72753297:<DEL>:305:2314.48:Lumpy:SVtyper:0.764","<DEL>","16",72753297,305,"intergenic",0,"Human",0.808510638,72753602
"15:48550271:<DEL>:320:705.19:Lumpy:SVtyper:0.185","<DEL>","15",48550271,320,NA,0,"Human",0.34893617,48550591
"8:126453442:<DEL>:308:376.19:Lumpy:SVtyper:0.014","<DEL>","8",126453442,308,"intergenic",0,"Human",0.029787234,126453750
"3:31109439:<DEL>:321:984.84:Lumpy:SVtyper:0.025","<DEL>","3",31109439,321,"intergenic",0,"Human",0.05106383,31109760
"7:4807750:<DEL>:320:282.61:Lumpy:SVtyper:0.011","<DEL>","7",4807750,320,NA,0,"Human",0.021276596,4808070
"2:161795612:<DEL>:324:3017.985:Lumpy:SVtyper:0.007","<DEL>","2",161795612,324,"intergenic",0,"Human",0.021276596,161795936
"17:79610353:<DEL>:315:990.895:Lumpy:SVtyper:0.217","<DEL>","17",79610353,315,NA,0,"Human",0.336170213,79610668
"14:83852041:<DEL>:323:856.75:Lumpy:SVtyper:0.333","<DEL>","14",83852041,323,"intergenic",0,"Human",0.570212766,83852364
"7:84320238:<DEL>:308:233.525:Lumpy:SVtyper:0.004","<DEL>","7",84320238,308,"intergenic",0,"Human",0.008510638,84320546
"3:2633037:<DEL>:321:576.55:Lumpy:SVtyper:0.322","<DEL>","3",2633037,321,NA,0,"Human",0.50212766,2633358
"2:152041206:<DEL>:288:871.85:Lumpy:SVtyper:0.442","<DEL>","2",152041206,288,"intergenic",0,"Human",0.740425532,152041494
"13:111232858:<DEL>:312:191.19:Lumpy:SVtyper:0.004","<DEL>","13",111232858,312,"intergenic",0,"Human",0.004255319,111233170
"X:145329902:<DEL>:311:877.56:Lumpy:SVtyper:0.435","<DEL>","X",145329902,311,"intergenic",0,"Human",0.553191489,145330213
"10:131595178:<DEL>:296:836.66:Lumpy:SVtyper:0.257","<DEL>","10",131595178,296,"intergenic",0,"Human",0.459574468,131595474
"19:20180435:<DEL>:316:326.16:Lumpy:SVtyper:0.011","<DEL>","19",20180435,316,"intergenic",0,"Human",0.021276596,20180751
"4:86660760:<DEL>:322:822.64:Lumpy:SVtyper:0.014","<DEL>","4",86660760,322,NA,0,"Human",0.012765957,86661082
"10:6169401:<DEL>:324:935.49:Lumpy:SVtyper:0.007","<DEL>","10",6169401,324,"intergenic",0,"Human",0.012765957,6169725
"13:80876607:<DEL>:307:556.33:Lumpy:SVtyper:0.004","<DEL>","13",80876607,307,"intergenic",0,"Human",0.008510638,80876914
"16:67253667:<DEL>:316:654.22:Lumpy:SVtyper:0.065","<DEL>","16",67253667,316,NA,0,"Human",0.123404255,67253983
"22:29177323:<DEL>:317:860.395:Lumpy:SVtyper:0.199","<DEL>","22",29177323,317,NA,0,"Human",0.370212766,29177640
"17:76111691:<DEL>:289:521.82:Lumpy:SVtyper:0.004","<DEL>","17",76111691,289,NA,0,"Human",0.004255319,76111980
"5:77574167:<DEL>:290:433.495:Lumpy:SVtyper:0.156","<DEL>","5",77574167,290,NA,0,"Human",0.29787234,77574457
"1:236408588:<DEL>:278:372.69:Lumpy:SVtyper:0.004","<DEL>","1",236408588,278,NA,0,"Human",0.004255319,236408866
"11:125053086:<DEL>:290:1490.49:Lumpy:SVtyper:0.337","<DEL>","11",125053086,290,NA,0,"Human",0.544680851,125053376
"4:177869328:<DEL>:316:2496.62:Lumpy:SVtyper:0.496","<DEL>","4",177869328,316,"intergenic",0,"Human",0.689361702,177869644
"6:22782653:<DEL>:321:852.3:Lumpy:SVtyper:0.094","<DEL>","6",22782653,321,"intergenic",0,"Human",0.161702128,22782974
"16:14470534:<DEL>:292:396.14:Lumpy:SVtyper:0.188","<DEL>","16",14470534,292,"intergenic",0,"Human",0.370212766,14470826
"11:14348313:<DEL>:316:1806.935:Lumpy:SVtyper:0.569","<DEL>","11",14348313,316,NA,0,"Human",0.770212766,14348629
"9:7371804:<DEL>:313:687.39:Lumpy:SVtyper:0.207","<DEL>","9",7371804,313,"intergenic",0,"Human",0.395744681,7372117
"1:70768116:<DEL>:323:245.265:Lumpy:SVtyper:0.004","<DEL>","1",70768116,323,NA,0,"Human",0.008510638,70768439
"12:29280244:<DEL>:316:1453.55:Lumpy:SVtyper:0.301","<DEL>","12",29280244,316,"intergenic",0,"Human",0.50212766,29280560
"2:26842640:<DEL>:314:205.75:Lumpy:SVtyper:0.004","<DEL>","2",26842640,314,NA,0,"Human",0.004255319,26842954
"20:19170063:<DEL>:316:701.69:Lumpy:SVtyper:0.072","<DEL>","20",19170063,316,"intergenic",0,"Human",0.144680851,19170379
"11:48120067:<DEL>:309:512.91:Lumpy:SVtyper:0.623","<DEL>","11",48120067,309,NA,0,"Human",0.778723404,48120376
"4:43751806:<DEL>:324:1035.67:Lumpy:SVtyper:0.536","<DEL>","4",43751806,324,"intergenic",0,"Human",0.812765957,43752130
"1:9123741:<DEL>:320:638.18:Lumpy:SVtyper:0.033","<DEL>","1",9123741,320,NA,0,"Human",0.068085106,9124061
"21:41586870:<DEL>:325:1991.845:Lumpy:SVtyper:0.489","<DEL>","21",41586870,325,NA,0,"Human",0.680851064,41587195
"1:80114173:<DEL>:317:1022.59:Lumpy:SVtyper:0.014","<DEL>","1",80114173,317,"intergenic",0,"Human",0.029787234,80114490
"4:100070297:<DEL>:316:842.595:Lumpy:SVtyper:0.819","<DEL>","4",100070297,316,"intergenic",0,"Human",0.90212766,100070613
"4:166895280:<DEL>:311:558.22:Lumpy:SVtyper:0.014","<DEL>","4",166895280,311,NA,0,"Human",0.017021277,166895591
"8:6062878:<DEL>:315:618.90:Lumpy:SVtyper:0.007","<DEL>","8",6062878,315,"intergenic",0,"Human",0.012765957,6063193
"5:22796605:<DEL>:324:987.01:Lumpy:SVtyper:0.120","<DEL>","5",22796605,324,NA,0,"Human",0.234042553,22796929
"19:6657119:<DEL>:313:1534.72:Lumpy:SVtyper:0.004","<DEL>","19",6657119,313,"intergenic",0,"Human",0.004255319,6657432
"16:3263265:<DEL>:286:513.86:Lumpy:SVtyper:0.029","<DEL>","16",3263265,286,"intergenic",0,"Human",0.046808511,3263551
"20:7884103:<DUP>:300:222.46:Lumpy:SVtyper:0.004","<DUP>","20",7884103,300,NA,0,"Human",0.008510638,7884403
"8:76126890:<DEL>:325:265.62:Lumpy:SVtyper:0.569","<DEL>","8",76126890,325,"intergenic",0,"Human",0.740425532,76127215
"12:11341902:<DEL>:314:860.115:Both:Both:0.293","<DEL>","12",11341902,314,"intergenic",0,"Human",0.493617021,11342216
"6:50765965:<DEL>:311:168.53:Lumpy:SVtyper:0.004","<DEL>","6",50765965,311,"intergenic",0,"Human",0.017021277,50766276
"4:150951032:<DEL>:322:349.475:Both:Both:0.004","<DEL>","4",150951032,322,"intergenic",0,"Human",0.008510638,150951354
"14:45888151:<DEL>:317:316.17:Lumpy:SVtyper:0.018","<DEL>","14",45888151,317,"intergenic",0,"Human",0.042553191,45888468
"7:14227994:<DEL>:318:958.82:Lumpy:SVtyper:0.101","<DEL>","7",14227994,318,NA,0,"Human",0.157446809,14228312
"12:23795731:<DEL>:313:444.95:Lumpy:SVtyper:0.127","<DEL>","12",23795731,313,NA,0,"Human",0.234042553,23796044
"6:32458437:<DEL>:320:447.66:Lumpy:SVtyper:0.004","<DEL>","6",32458437,320,"intergenic",0,"Human",0.008510638,32458757
"X:123762625:<DEL>:320:980.61:Lumpy:SVtyper:0.005","<DEL>","X",123762625,320,NA,0,"Human",0.008510638,123762945
"11:27789528:<DEL>:293:245.93:Lumpy:SVtyper:0.025","<DEL>","11",27789528,293,"intergenic",0,"Human",0.05106383,27789821
"2:167447704:<DEL>:316:324.4:Lumpy:SVtyper:0.007","<DEL>","2",167447704,316,"intergenic",0,"Human",0.008510638,167448020
"6:83676081:<DEL>:313:467.73:Lumpy:SVtyper:0.004","<DEL>","6",83676081,313,NA,0,"Human",0.008510638,83676394
"2:168895817:<DEL>:320:410.71:Lumpy:SVtyper:0.598","<DEL>","2",168895817,320,NA,0,"Human",0.791489362,168896137
"10:33492641:<DEL>:289:519.11:Lumpy:SVtyper:0.214","<DEL>","10",33492641,289,NA,0,"Human",0.395744681,33492930
"6:92910658:<DEL>:323:784.34:Lumpy:SVtyper:0.228","<DEL>","6",92910658,323,"intergenic",0,"Human",0.378723404,92910981
"16:70537486:<DEL>:313:581.14:Lumpy:SVtyper:0.007","<DEL>","16",70537486,313,NA,0,"Human",0.012765957,70537799
"5:170131208:<DEL>:314:518.03:Lumpy:SVtyper:0.087","<DEL>","5",170131208,314,NA,0,"Human",0.144680851,170131522
"13:42755926:<DEL>:279:1052.49:Lumpy:SVtyper:0.583","<DEL>","13",42755926,279,NA,0,"Human",0.774468085,42756205
"11:70806831:<DEL>:301:500.77:Lumpy:SVtyper:0.014","<DEL>","11",70806831,301,NA,0,"Human",0.017021277,70807132
"9:122531837:<DEL>:318:2041.63:Lumpy:SVtyper:0.812","<DEL>","9",122531837,318,"intergenic",0,"Human",0.821276596,122532155
"20:54463223:<DEL>:317:703.7:Lumpy:SVtyper:0.022","<DEL>","20",54463223,317,"intergenic",0,"Human",0.034042553,54463540
"4:98590657:<DEL>:318:608.64:Lumpy:SVtyper:0.007","<DEL>","4",98590657,318,NA,0,"Human",0.012765957,98590975
"15:70987808:<DUP>:288:276.23:Lumpy:SVtyper:0.011","<DUP>","15",70987808,288,NA,0,"Human",0.025531915,70988096
"3:45768353:<DEL>:325:764.25:Lumpy:SVtyper:0.525","<DEL>","3",45768353,325,NA,0,"Human",0.693617021,45768678
"11:96233124:<DEL>:312:301.89:Lumpy:SVtyper:0.007","<DEL>","11",96233124,312,"intergenic",0,"Human",0.012765957,96233436
"14:61775493:<DEL>:316:474.89:Lumpy:SVtyper:0.004","<DEL>","14",61775493,316,"intergenic",0,"Human",0.008510638,61775809
"17:37655098:<DEL>:325:784.235:Lumpy:SVtyper:0.478","<DEL>","17",37655098,325,NA,0,"Human",0.791489362,37655423
"6:95573685:<DEL>:325:541.50:Lumpy:SVtyper:0.004","<DEL>","6",95573685,325,"intergenic",0,"Human",0.004255319,95574010
"2:85335362:<DEL>:318:939.27:Lumpy:SVtyper:0.134","<DEL>","2",85335362,318,"intergenic",0,"Human",0.259574468,85335680
"9:26512919:<DEL>:324:919.185:Lumpy:SVtyper:0.399","<DEL>","9",26512919,324,"intergenic",0,"Human",0.638297872,26513243
"10:61441219:<DEL>:313:269.665:Lumpy:SVtyper:0.047","<DEL>","10",61441219,313,NA,0,"Human",0.093617021,61441532
"13:89522807:<DEL>:321:1020.58:Lumpy:SVtyper:0.011","<DEL>","13",89522807,321,"intergenic",0,"Human",0.021276596,89523128
"8:56401211:<DEL>:316:2622.155:Lumpy:SVtyper:0.014","<DEL>","8",56401211,316,NA,0,"Human",0.025531915,56401527
"8:10690905:<DEL>:315:174.875:Lumpy:SVtyper:0.004","<DEL>","8",10690905,315,NA,0,"Human",0.004255319,10691220
"10:11927248:<DEL>:301:642.62:Lumpy:SVtyper:0.004","<DEL>","10",11927248,301,"intergenic",0,"Human",0.008510638,11927549
"12:195743:<DEL>:322:677.68:Both:Both:0.004","<DEL>","12",195743,322,NA,0,"Human",0.004255319,196065
"3:68870478:<DEL>:290:633.995:Lumpy:SVtyper:0.011","<DEL>","3",68870478,290,NA,0,"Human",0.012765957,68870768
"6:168520375:<DUP>:301:182.14:Lumpy:SVtyper:0.417","<DUP>","6",168520375,301,"intergenic",0,"Human",0.855319149,168520676
"5:32039258:<DEL>:316:496.6:Lumpy:SVtyper:0.018","<DEL>","5",32039258,316,NA,0,"Human",0.038297872,32039574
"7:52107112:<DEL>:317:1256.145:Lumpy:SVtyper:0.424","<DEL>","7",52107112,317,"intergenic",0,"Human",0.617021277,52107429
"6:8227922:<DEL>:320:787.31:Lumpy:SVtyper:0.239","<DEL>","6",8227922,320,"intergenic",0,"Human",0.382978723,8228242
"X:80292898:<DEL>:312:1005.88:Lumpy:SVtyper:0.014","<DEL>","X",80292898,312,"intergenic",0,"Human",0.046808511,80293210
"9:102127922:<DEL>:315:275.33:Lumpy:Both:0.004","<DEL>","9",102127922,315,"intergenic",0,"Human",0.004255319,102128237
"5:50738613:<DEL>:286:485.795:Lumpy:SVtyper:0.004","<DEL>","5",50738613,286,"intergenic",0,"Human",0.008510638,50738899
"4:139948016:<DEL>:319:1256.69:Lumpy:SVtyper:0.565","<DEL>","4",139948016,319,NA,0,"Human",0.808510638,139948335
"1:164047817:<DEL>:315:679.30:Lumpy:SVtyper:0.004","<DEL>","1",164047817,315,"intergenic",0,"Human",0.004255319,164048132
"9:6888774:<DEL>:314:1160.74:Lumpy:SVtyper:0.341","<DEL>","9",6888774,314,NA,0,"Human",0.553191489,6889088
"1:202298093:<DEL>:292:1104.58:Lumpy:SVtyper:0.004","<DEL>","1",202298093,292,"intergenic",0,"Human",0.004255319,202298385
"8:106670520:<DEL>:320:1983.37:Lumpy:SVtyper:0.417","<DEL>","8",106670520,320,NA,0,"Human",0.617021277,106670840
"14:46100815:<DEL>:321:855.805:Both:Both:0.018","<DEL>","14",46100815,321,"intergenic",0,"Human",0.029787234,46101136
"14:48334249:<DEL>:315:381.03:Lumpy:SVtyper:0.007","<DEL>","14",48334249,315,"intergenic",0,"Human",0.012765957,48334564
"11:106160321:<DEL>:295:321.45:Lumpy:SVtyper:0.004","<DEL>","11",106160321,295,"intergenic",0,"Human",0.008510638,106160616
"1:151311617:<DEL>:317:560.91:Lumpy:SVtyper:0.004","<DEL>","1",151311617,317,"intergenic",0,"Human",0.012765957,151311934
"7:96067515:<DEL>:315:2478.535:Lumpy:SVtyper:0.007","<DEL>","7",96067515,315,"intergenic",0,"Human",0.008510638,96067830
"4:98590657:<DEL>:318:326.565:Lumpy:SVtyper:0.014","<DEL>","4",98590657,318,NA,0,"Human",0.025531915,98590975
"9:3078463:<DEL>:325:266.43:Lumpy:SVtyper:0.007","<DEL>","9",3078463,325,"intergenic",0,"Human",0.012765957,3078788
"17:3771184:<DEL>:324:674.18:Lumpy:SVtyper:0.011","<DEL>","17",3771184,324,NA,0,"Human",0.025531915,3771508
"16:72753291:<DEL>:305:2412.355:Lumpy:SVtyper:0.014","<DEL>","16",72753291,305,"intergenic",0,"Human",0.012765957,72753596
"7:136073056:<DEL>:286:182.835:Lumpy:SVtyper:0.004","<DEL>","7",136073056,286,"intergenic",0,"Human",0.004255319,136073342
"10:128106477:<DEL>:314:1875.16:Lumpy:SVtyper:0.652","<DEL>","10",128106477,314,"intergenic",0,"Human",0.791489362,128106791
"5:103030557:<DEL>:325:851.215:Lumpy:SVtyper:0.007","<DEL>","5",103030557,325,"intergenic",0,"Human",0.012765957,103030882
"7:20393267:<DEL>:319:795.67:Lumpy:SVtyper:0.004","<DEL>","7",20393267,319,NA,0,"Human",0.008510638,20393586
"11:68183100:<DEL>:310:285.58:Lumpy:SVtyper:0.025","<DEL>","11",68183100,310,NA,0,"Human",0.05106383,68183410
"5:88043142:<DEL>:325:1176.395:Lumpy:SVtyper:0.562","<DEL>","5",88043142,325,NA,0,"Human",0.731914894,88043467
"2:220946310:<DEL>:278:439.55:Lumpy:SVtyper:0.011","<DEL>","2",220946310,278,"intergenic",0,"Human",0.021276596,220946588
"8:6790872:<DEL>:322:579.79:Lumpy:SVtyper:0.692","<DEL>","8",6790872,322,"intergenic",0,"Human",0.770212766,6791194
"5:2541855:<DEL>:301:1180.65:Lumpy:SVtyper:0.014","<DEL>","5",2541855,301,"intergenic",0,"Human",0.021276596,2542156
"4:189793244:<DEL>:319:563.07:Lumpy:SVtyper:0.004","<DEL>","4",189793244,319,"intergenic",0,"Human",0.004255319,189793563
"10:105097527:<DEL>:314:584.115:Lumpy:SVtyper:0.312","<DEL>","10",105097527,314,NA,0,"Human",0.540425532,105097841
"21:43897097:<DEL>:290:101.26:Lumpy:SVtyper:0.004","<DEL>","21",43897097,290,NA,0,"Human",0.008510638,43897387
"12:108222553:<DEL>:316:441.17:Lumpy:SVtyper:0.304","<DEL>","12",108222553,316,"intergenic",0,"Human",0.553191489,108222869
"11:12081498:<DEL>:294:298.25:Lumpy:SVtyper:0.004","<DEL>","11",12081498,294,"intergenic",0,"Human",0.004255319,12081792
"2:73286755:<DEL>:286:793.64:Lumpy:SVtyper:0.069","<DEL>","2",73286755,286,NA,0,"Human",0.14893617,73287041
"3:39367275:<DEL>:304:577.10:Lumpy:SVtyper:0.004","<DEL>","3",39367275,304,"intergenic",0,"Human",0.004255319,39367579
"3:7400141:<DEL>:307:315.24:Lumpy:SVtyper:0.007","<DEL>","3",7400141,307,NA,0,"Human",0.008510638,7400448
"3:81346078:<DEL>:315:670.94:Lumpy:SVtyper:0.004","<DEL>","3",81346078,315,"intergenic",0,"Human",0.008510638,81346393
"20:21849904:<DEL>:287:522.34:Lumpy:SVtyper:0.449","<DEL>","20",21849904,287,"intergenic",0,"Human",0.646808511,21850191
"7:27514346:<DEL>:275:971.365:Lumpy:SVtyper:0.297","<DEL>","7",27514346,275,"intergenic",0,"Human",0.510638298,27514621
"16:87535890:<DUP>:285:112.33:Lumpy:SVtyper:0.076","<DUP>","16",87535890,285,"intergenic",0,"Human",0.14893617,87536175
"3:32203872:<DEL>:282:1124.95:Lumpy:SVtyper:0.261","<DEL>","3",32203872,282,NA,0,"Human",0.421276596,32204154
"2:128375057:<DEL>:324:665.55:Lumpy:SVtyper:0.004","<DEL>","2",128375057,324,NA,0,"Human",0.004255319,128375381
"20:41505144:<DUP>:289:287.14:Lumpy:SVtyper:0.004","<DUP>","20",41505144,289,NA,0,"Human",0.008510638,41505433
"6:68223039:<DEL>:275:608.38:Lumpy:SVtyper:0.018","<DEL>","6",68223039,275,"intergenic",0,"Human",0.042553191,68223314
"4:160952512:<DEL>:317:1803.45:Lumpy:SVtyper:0.014","<DEL>","4",160952512,317,"intergenic",0,"Human",0.034042553,160952829
"5:177721215:<DEL>:276:766.41:Lumpy:SVtyper:0.163","<DEL>","5",177721215,276,NA,0,"Human",0.289361702,177721491
"6:17472271:<DEL>:313:574.40:Lumpy:SVtyper:0.004","<DEL>","6",17472271,313,NA,0,"Human",0.008510638,17472584
"1:30030076:<DEL>:284:911.22:Lumpy:SVtyper:0.069","<DEL>","1",30030076,284,"intergenic",0,"Human",0.127659574,30030360
"2:154411698:<DEL>:315:726.22:Lumpy:SVtyper:0.094","<DEL>","2",154411698,315,"intergenic",0,"Human",0.161702128,154412013
"9:16780129:<DUP>:291:198:Lumpy:SVtyper:0.004","<DUP>","9",16780129,291,NA,0,"Human",0.008510638,16780420
"10:10708538:<DEL>:317:874.545:Lumpy:SVtyper:0.225","<DEL>","10",10708538,317,"intergenic",0,"Human",0.404255319,10708855
"12:66207064:<DEL>:292:279.64:Lumpy:SVtyper:0.004","<DEL>","12",66207064,292,"intergenic",0,"Human",0.004255319,66207356
"6:124498908:<DEL>:323:872.93:Lumpy:SVtyper:0.453","<DEL>","6",124498908,323,NA,0,"Human",0.676595745,124499231
"2:223481685:<DEL>:295:2791.235:Lumpy:SVtyper:0.594","<DEL>","2",223481685,295,NA,0,"Human",0.761702128,223481980
"11:22658792:<DEL>:317:293.40:Lumpy:SVtyper:0.022","<DEL>","11",22658792,317,"intergenic",0,"Human",0.046808511,22659109
"4:156419375:<DEL>:302:292.59:Lumpy:SVtyper:0.004","<DEL>","4",156419375,302,"intergenic",0,"Human",0.008510638,156419677
"5:113459039:<DEL>:323:695.21:Lumpy:SVtyper:0.246","<DEL>","5",113459039,323,"intergenic",0,"Human",0.4,113459362
"15:44578499:<DEL>:317:745.38:Lumpy:SVtyper:0.011","<DEL>","15",44578499,317,"intergenic",0,"Human",0.017021277,44578816
"4:89681472:<DEL>:322:1567.76:Lumpy:SVtyper:0.540","<DEL>","4",89681472,322,NA,0,"Human",0.714893617,89681794
"4:69959843:<DEL>:324:415.28:Lumpy:SVtyper:0.007","<DEL>","4",69959843,324,"intergenic",0,"Human",0.012765957,69960167
"19:606593:<DEL>:319:192.00:Lumpy:SVtyper:0.004","<DEL>","19",606593,319,NA,0,"Human",0.012765957,606912
"8:41930251:<DEL>:315:546.89:Lumpy:SVtyper:0.062","<DEL>","8",41930251,315,"intergenic",0,"Human",0.106382979,41930566
"10:3095646:<DEL>:285:1262.69:Lumpy:SVtyper:0.409","<DEL>","10",3095646,285,"intergenic",0,"Human",0.676595745,3095931
"3:137769942:<DUP>:298:122.87:Lumpy:SVtyper:0.007","<DUP>","3",137769942,298,"intergenic",0,"Human",0.008510638,137770240
"18:74769772:<DEL>:301:478.535:Both:Both:0.482","<DEL>","18",74769772,301,NA,0,"Human",0.680851064,74770073
"4:81456361:<DEL>:316:292.84:Lumpy:SVtyper:0.011","<DEL>","4",81456361,316,NA,0,"Human",0.012765957,81456677
"10:61365490:<DEL>:319:1367.60:Lumpy:SVtyper:0.754","<DEL>","10",61365490,319,"intergenic",0,"Human",0.782978723,61365809
"20:47170303:<DEL>:297:706:Lumpy:SVtyper:0.004","<DEL>","20",47170303,297,"intergenic",0,"Human",0.008510638,47170600
"15:75867323:<DEL>:303:1502.36:Lumpy:SVtyper:0.438","<DEL>","15",75867323,303,NA,0,"Human",0.625531915,75867626
"13:68977869:<DEL>:324:753.865:Lumpy:SVtyper:0.308","<DEL>","13",68977869,324,"intergenic",0,"Human",0.578723404,68978193
"5:13895087:<DEL>:297:273.43:Lumpy:SVtyper:0.007","<DEL>","5",13895087,297,NA,0,"Human",0.012765957,13895384
"13:104009858:<DEL>:319:800.255:Lumpy:SVtyper:0.326","<DEL>","13",104009858,319,"intergenic",0,"Human",0.570212766,104010177
"11:68183100:<DEL>:310:510.625:Lumpy:SVtyper:0.543","<DEL>","11",68183100,310,NA,0,"Human",0.685106383,68183410
"4:86310520:<DEL>:311:362.695:Lumpy:SVtyper:0.007","<DEL>","4",86310520,311,"intergenic",0,"Human",0.012765957,86310831
"2:134868822:<DEL>:319:738.63:Lumpy:SVtyper:0.083","<DEL>","2",134868822,319,"intergenic",0,"Human",0.144680851,134869141
"4:83395516:<DEL>:321:718.95:Lumpy:SVtyper:0.004","<DEL>","4",83395516,321,"intergenic",0,"Human",0.008510638,83395837
"2:31342738:<DEL>:315:471.92:Lumpy:SVtyper:0.004","<DEL>","2",31342738,315,NA,0,"Human",0.004255319,31343053
"18:47019854:<DEL>:322:475.155:Lumpy:SVtyper:0.377","<DEL>","18",47019854,322,NA,0,"Human",0.582978723,47020176
"18:62385771:<DEL>:314:236.50:Lumpy:SVtyper:0.272","<DEL>","18",62385771,314,"intergenic",0,"Human",0.463829787,62386085
"5:120313032:<DEL>:315:743.89:Lumpy:SVtyper:0.141","<DEL>","5",120313032,315,"intergenic",0,"Human",0.238297872,120313347
"9:74375322:<DEL>:297:532.32:Lumpy:SVtyper:0.018","<DEL>","9",74375322,297,NA,0,"Human",0.034042553,74375619
"3:28167461:<DEL>:322:692.51:Lumpy:SVtyper:0.203","<DEL>","3",28167461,322,"intergenic",0,"Human",0.357446809,28167783
"3:26945654:<DEL>:312:432.81:Lumpy:SVtyper:0.007","<DEL>","3",26945654,312,"intergenic",0,"Human",0.012765957,26945966
"16:22908974:<DEL>:278:1697.97:Lumpy:SVtyper:0.431","<DEL>","16",22908974,278,NA,0,"Human",0.625531915,22909252
"8:64144871:<DEL>:312:733.24:Lumpy:SVtyper:0.004","<DEL>","8",64144871,312,"intergenic",0,"Human",0.008510638,64145183
"4:135163161:<DEL>:287:565.22:Lumpy:SVtyper:0.014","<DEL>","4",135163161,287,"intergenic",0,"Human",0.029787234,135163448
"7:141113872:<DEL>:319:169.59:Lumpy:SVtyper:0.007","<DEL>","7",141113872,319,NA,0,"Human",0.008510638,141114191
"X:79072222:<DEL>:289:2192.97:Lumpy:SVtyper:0.005","<DEL>","X",79072222,289,"intergenic",0,"Human",0.004255319,79072511
"3:82957278:<DEL>:298:319.02:Lumpy:SVtyper:0.297","<DEL>","3",82957278,298,"intergenic",0,"Human",0.557446809,82957576
"14:71689974:<DEL>:307:686.31:Lumpy:SVtyper:0.043","<DEL>","14",71689974,307,"intergenic",0,"Human",0.085106383,71690281
"19:55427796:<DUP>:300:332.11:Lumpy:SVtyper:0.004","<DUP>","19",55427796,300,"intergenic",0,"Human",0.004255319,55428096
"7:42549707:<DEL>:322:2149.30:Lumpy:SVtyper:0.609","<DEL>","7",42549707,322,"intergenic",0,"Human",0.804255319,42550029
"6:111295218:<DEL>:307:278.83:Lumpy:SVtyper:0.047","<DEL>","6",111295218,307,"intergenic",0,"Human",0.09787234,111295525
"7:155725360:<DEL>:296:521.275:Lumpy:SVtyper:0.004","<DEL>","7",155725360,296,"intergenic",0,"Human",0.008510638,155725656
"3:174161557:<DEL>:281:767.48:Lumpy:SVtyper:0.014","<DEL>","3",174161557,281,"intergenic",0,"Human",0.034042553,174161838
"6:37294963:<DEL>:323:355.15:Lumpy:SVtyper:0.007","<DEL>","6",37294963,323,NA,0,"Human",0.017021277,37295286
"X:71123222:<DEL>:317:867.97:Lumpy:SVtyper:0.739","<DEL>","X",71123222,317,"intergenic",0,"Human",0.753191489,71123539
"19:49484246:<DEL>:318:414.89:Lumpy:SVtyper:0.004","<DEL>","19",49484246,318,NA,0,"Human",0.008510638,49484564
"16:23528541:<DEL>:313:1445.73:Lumpy:SVtyper:0.471","<DEL>","16",23528541,313,"intergenic",0,"Human",0.765957447,23528854
"6:57239069:<DEL>:321:349.755:Lumpy:SVtyper:0.380","<DEL>","6",57239069,321,NA,0,"Human",0.753191489,57239390
"6:44613495:<DEL>:316:1221.63:Lumpy:SVtyper:0.141","<DEL>","6",44613495,316,"intergenic",0,"Human",0.259574468,44613811
"5:116694514:<DEL>:324:639.53:Lumpy:SVtyper:0.072","<DEL>","5",116694514,324,"intergenic",0,"Human",0.127659574,116694838
"9:107400983:<DEL>:314:512.78:Lumpy:SVtyper:0.236","<DEL>","9",107400983,314,"intergenic",0,"Human",0.395744681,107401297
"1:237331904:<DUP>:309:473.475:Lumpy:SVtyper:0.004","<DUP>","1",237331904,309,NA,0,"Human",0.008510638,237332213
"3:190290640:<DEL>:297:895.58:Lumpy:SVtyper:0.377","<DEL>","3",190290640,297,NA,0,"Human",0.578723404,190290937
"5:82906065:<DEL>:313:753.195:Lumpy:SVtyper:0.562","<DEL>","5",82906065,313,"intergenic",0,"Human",0.736170213,82906378
"17:37622459:<DEL>:306:197.12:Lumpy:SVtyper:0.004","<DEL>","17",37622459,306,NA,0,"Human",0.004255319,37622765
"16:530757:<DEL>:312:204.40:Lumpy:SVtyper:0.011","<DEL>","16",530757,312,NA,0,"Human",0.017021277,531069
"2:102356613:<DEL>:315:1036.095:Lumpy:SVtyper:0.051","<DEL>","2",102356613,315,NA,0,"Human",0.10212766,102356928
"7:82946466:<DEL>:318:606.49:Lumpy:SVtyper:0.402","<DEL>","7",82946466,318,"intergenic",0,"Human",0.6,82946784
"10:58863548:<DEL>:319:432.27:Lumpy:SVtyper:0.163","<DEL>","10",58863548,319,"intergenic",0,"Human",0.289361702,58863867
"9:36309289:<DEL>:321:1133.09:Lumpy:SVtyper:0.384","<DEL>","9",36309289,321,"intergenic",0,"Human",0.621276596,36309610
"4:59607596:<DEL>:320:590.58:Lumpy:SVtyper:0.210","<DEL>","4",59607596,320,"intergenic",0,"Human",0.365957447,59607916
"2:82340457:<DEL>:320:2256.59:Lumpy:SVtyper:0.605","<DEL>","2",82340457,320,"intergenic",0,"Human",0.731914894,82340777
"3:192063185:<DEL>:310:841.38:Lumpy:SVtyper:0.377","<DEL>","3",192063185,310,NA,0,"Human",0.578723404,192063495
"13:111329765:<DEL>:303:1442.81:Both:Both:0.120","<DEL>","13",111329765,303,NA,0,"Human",0.140425532,111330068
"5:33200860:<DEL>:312:826.28:Lumpy:SVtyper:0.475","<DEL>","5",33200860,312,"intergenic",0,"Human",0.676595745,33201172
"11:102471850:<DEL>:316:798.23:Lumpy:SVtyper:0.460","<DEL>","11",102471850,316,NA,0,"Human",0.680851064,102472166
"5:16698727:<DEL>:311:566.305:Lumpy:SVtyper:0.004","<DEL>","5",16698727,311,NA,0,"Human",0.008510638,16699038
"3:8720632:<DEL>:285:396.96:Lumpy:SVtyper:0.004","<DEL>","3",8720632,285,"intergenic",0,"Human",0.008510638,8720917
"19:40257545:<DEL>:306:1250.215:Lumpy:SVtyper:0.058","<DEL>","19",40257545,306,"intergenic",0,"Human",0.114893617,40257851
"9:12898001:<DEL>:317:289.35:Lumpy:SVtyper:0.072","<DEL>","9",12898001,317,"intergenic",0,"Human",0.174468085,12898318
"21:20123884:<DEL>:316:902.32:Lumpy:SVtyper:0.192","<DEL>","21",20123884,316,"intergenic",0,"Human",0.310638298,20124200
"10:56517036:<DEL>:313:952.62:Lumpy:SVtyper:0.486","<DEL>","10",56517036,313,NA,0,"Human",0.714893617,56517349
"11:134665414:<DEL>:321:129.42:Lumpy:SVtyper:0","<DEL>","11",134665414,321,"intergenic",0,"Human",0.004255319,134665735
"20:49724941:<DEL>:284:972.695:Lumpy:Both:0.007","<DEL>","20",49724941,284,"intergenic",0,"Human",0.008510638,49725225
"9:33050834:<DEL>:310:327.105:Lumpy:SVtyper:0.257","<DEL>","9",33050834,310,NA,0,"Human",0.463829787,33051144
"10:121153884:<DEL>:309:544.735:Lumpy:SVtyper:0.112","<DEL>","10",121153884,309,NA,0,"Human",0.195744681,121154193
"1:173207592:<DEL>:288:815.49:Lumpy:SVtyper:0.018","<DEL>","1",173207592,288,"intergenic",0,"Human",0.042553191,173207880
"3:192358883:<DEL>:310:585.46:Lumpy:SVtyper:0.152","<DEL>","3",192358883,310,NA,0,"Human",0.204255319,192359193
"7:37350525:<DEL>:300:709.095:Lumpy:SVtyper:0.011","<DEL>","7",37350525,300,NA,0,"Human",0.025531915,37350825
"4:185665772:<DEL>:318:1426.23:Lumpy:SVtyper:0.793","<DEL>","4",185665772,318,"intergenic",0,"Human",0.829787234,185666090
"1:7925014:<DEL>:281:151.82:Lumpy:SVtyper:0.076","<DEL>","1",7925014,281,"intergenic",0,"Human",0.144680851,7925295
"17:35143430:<DEL>:319:764.12:Lumpy:SVtyper:0.275","<DEL>","17",35143430,319,"intergenic",0,"Human",0.45106383,35143749
"12:59373904:<DEL>:325:765.595:Lumpy:SVtyper:0.083","<DEL>","12",59373904,325,"intergenic",0,"Human",0.144680851,59374229
"13:31426145:<DEL>:307:778.81:Lumpy:SVtyper:0.105","<DEL>","13",31426145,307,"intergenic",0,"Human",0.217021277,31426452
"5:2862806:<DEL>:276:433.63:Lumpy:SVtyper:0.025","<DEL>","5",2862806,276,"intergenic",0,"Human",0.038297872,2863082
"9:29624696:<DEL>:321:1196.00:Lumpy:SVtyper:0.786","<DEL>","9",29624696,321,"intergenic",0,"Human",0.868085106,29625017
"4:183082282:<DEL>:308:335.47:Lumpy:SVtyper:0.091","<DEL>","4",183082282,308,"intergenic",0,"Human",0.170212766,183082590
"4:88775645:<DEL>:317:583.83:Lumpy:SVtyper:0.214","<DEL>","4",88775645,317,"intergenic",0,"Human",0.370212766,88775962
"18:9923069:<DEL>:302:347.32:Lumpy:SVtyper:0.007","<DEL>","18",9923069,302,NA,0,"Human",0.008510638,9923371
"10:18545320:<DUP>:298:559.56:Lumpy:SVtyper:0.051","<DUP>","10",18545320,298,NA,0,"Human",0.09787234,18545618
"7:101334199:<DEL>:320:1256.96:Lumpy:SVtyper:0.007","<DEL>","7",101334199,320,"intergenic",0,"Human",0.012765957,101334519
"1:219923312:<DEL>:318:1619.805:Lumpy:SVtyper:0.707","<DEL>","1",219923312,318,"intergenic",0,"Human",0.906382979,219923630
"6:123515066:<DEL>:315:3234.27:Lumpy:SVtyper:0.696","<DEL>","6",123515066,315,"intergenic",0,"Human",0.821276596,123515381
"9:74269391:<DEL>:281:2352.83:Lumpy:SVtyper:0.601","<DEL>","9",74269391,281,"intergenic",0,"Human",0.765957447,74269672
"6:38140522:<DEL>:315:348.67:Lumpy:SVtyper:0.004","<DEL>","6",38140522,315,NA,0,"Human",0.012765957,38140837
"4:160670032:<DEL>:297:1625.70:Lumpy:SVtyper:0.011","<DEL>","4",160670032,297,"intergenic",0,"Human",0.012765957,160670329
"X:44567440:<DEL>:298:911.25:Lumpy:SVtyper:0.005","<DEL>","X",44567440,298,"intergenic",0,"Human",0.004255319,44567738
"6:10070793:<DEL>:313:1796.42:Lumpy:SVtyper:0.598","<DEL>","6",10070793,313,"intergenic",0,"Human",0.787234043,10071106
"8:13169590:<DEL>:320:1335.775:Lumpy:SVtyper:0.065","<DEL>","8",13169590,320,NA,0,"Human",0.119148936,13169910
"6:23300365:<DEL>:323:582.47:Lumpy:SVtyper:0.007","<DEL>","6",23300365,323,"intergenic",0,"Human",0.012765957,23300688
"12:130409142:<DEL>:307:455.33:Lumpy:SVtyper:0.007","<DEL>","12",130409142,307,"intergenic",0,"Human",0.012765957,130409449
"4:116421770:<DEL>:292:431.46:Lumpy:SVtyper:0.004","<DEL>","4",116421770,292,"intergenic",0,"Human",0.004255319,116422062
"2:18574238:<DEL>:294:727.58:Lumpy:SVtyper:0.138","<DEL>","2",18574238,294,"intergenic",0,"Human",0.259574468,18574532
"2:134460265:<DEL>:307:1718.99:Lumpy:SVtyper:0.514","<DEL>","2",134460265,307,"intergenic",0,"Human",0.693617021,134460572
"10:2379476:<DEL>:322:1021.53:Lumpy:SVtyper:0.420","<DEL>","10",2379476,322,"intergenic",0,"Human",0.6,2379798
"5:73648986:<DEL>:318:537.72:Lumpy:SVtyper:0.011","<DEL>","5",73648986,318,"intergenic",0,"Human",0.012765957,73649304
"18:74730089:<DEL>:297:177.16:Lumpy:SVtyper:0.203","<DEL>","18",74730089,297,NA,0,"Human",0.434042553,74730386
"13:70861674:<DEL>:325:919.59:Lumpy:SVtyper:0.120","<DEL>","13",70861674,325,"intergenic",0,"Human",0.208510638,70861999
"22:42498841:<DEL>:319:513.18:Lumpy:SVtyper:0.014","<DEL>","22",42498841,319,"intergenic",0,"Human",0.029787234,42499160
"4:36780616:<DEL>:323:372.005:Lumpy:SVtyper:0.098","<DEL>","4",36780616,323,"intergenic",0,"Human",0.178723404,36780939
"8:62930144:<DEL>:312:744.83:Lumpy:SVtyper:0.178","<DEL>","8",62930144,312,"intergenic",0,"Human",0.30212766,62930456
"14:55438995:<DUP>:301:511.74:Lumpy:SVtyper:0.004","<DUP>","14",55438995,301,NA,0,"Human",0.004255319,55439296
"2:20666676:<DEL>:307:1667.42:Lumpy:SVtyper:0.014","<DEL>","2",20666676,307,"intergenic",0,"Human",0.012765957,20666983
"1:73753601:<DEL>:315:1271.51:Both:Both:0.007","<DEL>","1",73753601,315,"intergenic",0,"Human",0.021276596,73753916
"1:4155150:<DEL>:314:240.26:Lumpy:SVtyper:0.210","<DEL>","1",4155150,314,"intergenic",0,"Human",0.336170213,4155464
"17:11557375:<DEL>:321:831.54:Lumpy:SVtyper:0.293","<DEL>","17",11557375,321,NA,0,"Human",0.468085106,11557696
"11:16597570:<DEL>:323:2823.14:Lumpy:SVtyper:0.014","<DEL>","11",16597570,323,"intergenic",0,"Human",0.012765957,16597893
"4:66641114:<DEL>:311:2442.06:Both:Both:0.011","<DEL>","4",66641114,311,"intergenic",0,"Human",0.012765957,66641425
"1:42144090:<DEL>:318:430.66:Lumpy:SVtyper:0.004","<DEL>","1",42144090,318,NA,0,"Human",0.004255319,42144408
"3:170119571:<DEL>:313:958.15:Lumpy:SVtyper:0.007","<DEL>","3",170119571,313,"intergenic",0,"Human",0.017021277,170119884
"20:35815613:<DEL>:312:179.595:Lumpy:SVtyper:0.004","<DEL>","20",35815613,312,NA,0,"Human",0.008510638,35815925
"9:36588175:<DEL>:324:169.35:Lumpy:SVtyper:0.011","<DEL>","9",36588175,324,NA,0,"Human",0.012765957,36588499
"2:182355981:<DEL>:315:2187.64:Lumpy:SVtyper:0.014","<DEL>","2",182355981,315,NA,0,"Human",0.012765957,182356296
"1:117078165:<DEL>:321:834.91:Lumpy:SVtyper:0.109","<DEL>","1",117078165,321,NA,0,"Human",0.212765957,117078486
"9:81725762:<DEL>:321:736.74:Both:Both:0.007","<DEL>","9",81725762,321,"intergenic",0,"Human",0.021276596,81726083
"11:81165240:<DEL>:320:557.14:Lumpy:SVtyper:0.004","<DEL>","11",81165240,320,"intergenic",0,"Human",0.008510638,81165560
"1:103096076:<DEL>:319:472.855:Lumpy:SVtyper:0.007","<DEL>","1",103096076,319,"intergenic",0,"Human",0.012765957,103096395
"5:99608155:<DEL>:312:515.34:Lumpy:SVtyper:0.272","<DEL>","5",99608155,312,"intergenic",0,"Human",0.459574468,99608467
"X:32391265:<DEL>:316:1341.63:Lumpy:SVtyper:0.024","<DEL>","X",32391265,316,NA,0,"Human",0.029787234,32391581
"5:1941146:<DEL>:310:573.31:Lumpy:SVtyper:0.315","<DEL>","5",1941146,310,"intergenic",0,"Human",0.540425532,1941456
"13:98721238:<DEL>:320:1654.75:Lumpy:SVtyper:0.645","<DEL>","13",98721238,320,"intergenic",0,"Human",0.736170213,98721558
"3:110256973:<DEL>:284:1304.545:Lumpy:SVtyper:0.127","<DEL>","3",110256973,284,"intergenic",0,"Human",0.259574468,110257257
"8:15387297:<DEL>:303:154.50:Lumpy:SVtyper:0.007","<DEL>","8",15387297,303,"intergenic",0,"Human",0.008510638,15387600
"11:61944788:<DEL>:298:825.87:Lumpy:SVtyper:0.413","<DEL>","11",61944788,298,"intergenic",0,"Human",0.693617021,61945086
"5:6830863:<DUP>:285:251.30:Lumpy:SVtyper:0.007","<DUP>","5",6830863,285,"intergenic",0,"Human",0.017021277,6831148
"4:114538762:<DEL>:303:772.07:Lumpy:SVtyper:0.004","<DEL>","4",114538762,303,NA,0,"Human",0.004255319,114539065
"19:30953708:<DEL>:323:108.135:Lumpy:SVtyper:0.018","<DEL>","19",30953708,323,NA,0,"Human",0.025531915,30954031
"12:131093928:<DEL>:297:2002.215:Lumpy:SVtyper:0.072","<DEL>","12",131093928,297,"intergenic",0,"Human",0.136170213,131094225
"16:77840162:<DEL>:304:338.43:Lumpy:SVtyper:0.004","<DEL>","16",77840162,304,NA,0,"Human",0.008510638,77840466
"9:10498746:<DEL>:310:2047.88:Lumpy:SVtyper:0.804","<DEL>","9",10498746,310,NA,0,"Human",0.842553191,10499056
"13:104522130:<DEL>:313:541.765:Lumpy:SVtyper:0.004","<DEL>","13",104522130,313,"intergenic",0,"Human",0.008510638,104522443
"4:134295544:<DEL>:320:115.94:Lumpy:SVtyper:0.014","<DEL>","4",134295544,320,"intergenic",0,"Human",0.034042553,134295864
"3:61475051:<DEL>:323:770.72:Lumpy:SVtyper:0.123","<DEL>","3",61475051,323,"intergenic",0,"Human",0.221276596,61475374
"3:116275279:<DEL>:324:1813.74:Lumpy:SVtyper:0.804","<DEL>","3",116275279,324,"intergenic",0,"Human",0.795744681,116275603
"4:34495874:<DEL>:294:753.325:Lumpy:SVtyper:0.007","<DEL>","4",34495874,294,"intergenic",0,"Human",0.008510638,34496168
"7:106022064:<DEL>:277:108.66:Lumpy:SVtyper:0.004","<DEL>","7",106022064,277,"intergenic",0,"Human",0.008510638,106022341
"10:111036387:<DEL>:320:768.84:Lumpy:SVtyper:0.319","<DEL>","10",111036387,320,"intergenic",0,"Human",0.531914894,111036707
"16:87806525:<DEL>:279:532.87:Lumpy:SVtyper:0.004","<DEL>","16",87806525,279,"intergenic",0,"Human",0.008510638,87806804
"4:120017241:<DEL>:320:1735.37:Lumpy:SVtyper:0.007","<DEL>","4",120017241,320,"intergenic",0,"Human",0.012765957,120017561
"2:25227630:<DEL>:315:445.89:Lumpy:SVtyper:0.007","<DEL>","2",25227630,315,"intergenic",0,"Human",0.017021277,25227945
"22:18283899:<DEL>:322:591.92:Lumpy:SVtyper:0.243","<DEL>","22",18283899,322,NA,0,"Human",0.463829787,18284221
"5:124717350:<DEL>:322:1123.73:Lumpy:SVtyper:0.007","<DEL>","5",124717350,322,"intergenic",0,"Human",0.012765957,124717672
"7:14449046:<DEL>:321:864.44:Lumpy:SVtyper:0.667","<DEL>","7",14449046,321,NA,0,"Human",0.804255319,14449367
"5:77062316:<DEL>:310:1437.26:Lumpy:SVtyper:0.576","<DEL>","5",77062316,310,NA,0,"Human",0.855319149,77062626
"3:195487174:<DEL>:308:687.39:Lumpy:SVtyper:0.004","<DEL>","3",195487174,308,NA,0,"Human",0.008510638,195487482
"7:147355065:<DEL>:313:512.10:Lumpy:SVtyper:0.141","<DEL>","7",147355065,313,NA,0,"Human",0.259574468,147355378
"11:119719520:<DEL>:288:719.35:Lumpy:SVtyper:0.025","<DEL>","11",119719520,288,"intergenic",0,"Human",0.038297872,119719808
"6:167905401:<DEL>:277:352.18:Lumpy:SVtyper:0.004","<DEL>","6",167905401,277,"intergenic",0,"Human",0.008510638,167905678
"6:32313777:<DEL>:323:802.675:Lumpy:SVtyper:0.025","<DEL>","6",32313777,323,NA,0,"Human",0.055319149,32314100
"11:48120067:<DEL>:309:388.18:Lumpy:SVtyper:0.007","<DEL>","11",48120067,309,NA,0,"Human",0.012765957,48120376
"9:117857610:<DEL>:319:140.495:Lumpy:SVtyper:0.007","<DEL>","9",117857610,319,NA,0,"Human",0.012765957,117857929
"10:66268796:<DEL>:309:1721.465:Lumpy:SVtyper:0.004","<DEL>","10",66268796,309,"intergenic",0,"Human",0.008510638,66269105
"6:51256296:<DEL>:316:508.59:Lumpy:SVtyper:0.007","<DEL>","6",51256296,316,"intergenic",0,"Human",0.008510638,51256612
"2:166267514:<DEL>:323:1085.825:Lumpy:SVtyper:0.551","<DEL>","2",166267514,323,"intergenic",0,"Human",0.753191489,166267837
"13:96633430:<DEL>:318:1788.245:Lumpy:SVtyper:0.033","<DEL>","13",96633430,318,NA,0,"Human",0.042553191,96633748
"4:23721677:<DEL>:321:894.24:Lumpy:SVtyper:0.417","<DEL>","4",23721677,321,"intergenic",0,"Human",0.638297872,23721998
"7:104129516:<DEL>:281:1080.57:Lumpy:SVtyper:0.007","<DEL>","7",104129516,281,NA,0,"Human",0.008510638,104129797
"20:35815613:<DEL>:312:2110.58:Lumpy:SVtyper:0.583","<DEL>","20",35815613,312,NA,0,"Human",0.753191489,35815925
"4:32540613:<DEL>:316:1433.06:Lumpy:SVtyper:0.007","<DEL>","4",32540613,316,"intergenic",0,"Human",0.008510638,32540929
"16:1998021:<DEL>:286:303.915:Lumpy:SVtyper:0.004","<DEL>","16",1998021,286,NA,0,"Human",0.008510638,1998307
"18:9036086:<DEL>:289:1149.67:Lumpy:SVtyper:0.721","<DEL>","18",9036086,289,"intergenic",0,"Human",0.8,9036375
"8:34022526:<DEL>:281:871.04:Lumpy:SVtyper:0.116","<DEL>","8",34022526,281,"intergenic",0,"Human",0.212765957,34022807
"20:60140157:<DEL>:312:396:Lumpy:SVtyper:0.007","<DEL>","20",60140157,312,NA,0,"Human",0.017021277,60140469
"7:127791918:<DEL>:317:332.635:Lumpy:SVtyper:0.007","<DEL>","7",127791918,317,"intergenic",0,"Human",0.008510638,127792235
"1:172606522:<DEL>:321:638.715:Lumpy:SVtyper:0.011","<DEL>","1",172606522,321,"intergenic",0,"Human",0.017021277,172606843
"11:77519573:<DEL>:319:613.495:Lumpy:SVtyper:0.004","<DEL>","11",77519573,319,NA,0,"Human",0.008510638,77519892
"9:508546:<DEL>:281:1048.49:Lumpy:SVtyper:0.004","<DEL>","9",508546,281,NA,0,"Human",0.008510638,508827
"4:11452386:<DEL>:280:1005.61:Lumpy:SVtyper:0.004","<DEL>","4",11452386,280,"intergenic",0,"Human",0.004255319,11452666
"18:9015183:<DEL>:298:490.26:Lumpy:SVtyper:0.004","<DEL>","18",9015183,298,"intergenic",0,"Human",0.008510638,9015481
"5:116428183:<DEL>:318:955.46:Lumpy:SVtyper:0.507","<DEL>","5",116428183,318,"intergenic",0,"Human",0.723404255,116428501
"7:6508838:<DEL>:322:288.675:Lumpy:SVtyper:0.004","<DEL>","7",6508838,322,"NM_001100603;KDELR2;1/4_exons",1,"Human",0.008510638,6509160
"11:17195844:<DEL>:313:645.87:Lumpy:SVtyper:0.341","<DEL>","11",17195844,313,"intergenic",0,"Human",0.672340426,17196157
"8:2129700:<DEL>:324:177.70:Lumpy:SVtyper:0.004","<DEL>","8",2129700,324,"intergenic",0,"Human",0.004255319,2130024
"6:32749232:<DEL>:311:640.47:Lumpy:SVtyper:0.565","<DEL>","6",32749232,311,"intergenic",0,"Human",0.731914894,32749543
"1:245466490:<DEL>:310:702.905:Lumpy:SVtyper:0.004","<DEL>","1",245466490,310,NA,0,"Human",0.008510638,245466800
"18:45099900:<DEL>:312:900.70:Lumpy:SVtyper:0.091","<DEL>","18",45099900,312,"intergenic",0,"Human",0.14893617,45100212
"2:152617292:<DEL>:315:2113.71:Lumpy:SVtyper:0.728","<DEL>","2",152617292,315,"intergenic",0,"Human",0.791489362,152617607
"13:104144384:<DEL>:283:2172.525:Lumpy:SVtyper:0.641","<DEL>","13",104144384,283,"intergenic",0,"Human",0.808510638,104144667
"5:78276753:<DEL>:319:723.265:Lumpy:SVtyper:0.667","<DEL>","5",78276753,319,NA,0,"Human",0.765957447,78277072
"16:83003976:<DEL>:295:179.36:Lumpy:SVtyper:0.062","<DEL>","16",83003976,295,NA,0,"Human",0.09787234,83004271
"10:78800903:<DEL>:319:1279.84:Lumpy:SVtyper:0.725","<DEL>","10",78800903,319,NA,0,"Human",0.808510638,78801222
"7:51691905:<DEL>:323:929.56:Lumpy:SVtyper:0.145","<DEL>","7",51691905,323,"intergenic",0,"Human",0.238297872,51692228
"11:16223166:<DEL>:319:627.39:Lumpy:SVtyper:0.051","<DEL>","11",16223166,319,NA,0,"Human",0.10212766,16223485
"7:89837380:<DEL>:286:390.215:Lumpy:SVtyper:0.004","<DEL>","7",89837380,286,"intergenic",0,"Human",0.008510638,89837666
"10:129935568:<DEL>:312:480.82:Lumpy:SVtyper:0.236","<DEL>","10",129935568,312,"intergenic",0,"Human",0.382978723,129935880
"6:86026358:<DEL>:316:1694.1:Lumpy:SVtyper:0.565","<DEL>","6",86026358,316,"intergenic",0,"Human",0.727659574,86026674
"4:160952512:<DEL>:317:172.03:Lumpy:SVtyper:0.025","<DEL>","4",160952512,317,"intergenic",0,"Human",0.038297872,160952829
"7:52094975:<DEL>:313:762.63:Lumpy:SVtyper:0.007","<DEL>","7",52094975,313,"intergenic",0,"Human",0.012765957,52095288
"10:134067915:<DEL>:315:155.855:Lumpy:SVtyper:0.065","<DEL>","10",134067915,315,NA,0,"Human",0.114893617,134068230
"9:115937090:<DEL>:295:1748.49:Lumpy:SVtyper:0.649","<DEL>","9",115937090,295,NA,0,"Human",0.736170213,115937385
"5:80039380:<DEL>:309:158.82:Lumpy:SVtyper:0.004","<DEL>","5",80039380,309,NA,0,"Human",0.004255319,80039689
"8:70357617:<DEL>:313:734.86:Lumpy:SVtyper:0.007","<DEL>","8",70357617,313,"intergenic",0,"Human",0.012765957,70357930
"8:4941227:<DEL>:297:1844.72:Lumpy:SVtyper:0.337","<DEL>","8",4941227,297,"intergenic",0,"Human",0.506382979,4941524
"8:64769692:<DEL>:308:869.02:Lumpy:SVtyper:0.007","<DEL>","8",64769692,308,"intergenic",0,"Human",0.012765957,64770000
"18:33537496:<DEL>:296:405.31:Lumpy:SVtyper:0.011","<DEL>","18",33537496,296,"intergenic",0,"Human",0.017021277,33537792
"X:45587564:<DEL>:307:789.735:Lumpy:SVtyper:0.053","<DEL>","X",45587564,307,"intergenic",0,"Human",0.068085106,45587871
"8:142681409:<DEL>:308:355.56:Lumpy:SVtyper:0.004","<DEL>","8",142681409,308,"intergenic",0,"Human",0.008510638,142681717
"1:241149864:<DEL>:325:1890.265:Lumpy:SVtyper:0.732","<DEL>","1",241149864,325,NA,0,"Human",0.782978723,241150189
"8:95006231:<DEL>:284:406.515:Lumpy:SVtyper:0.004","<DEL>","8",95006231,284,"intergenic",0,"Human",0.008510638,95006515
"13:89253466:<DEL>:316:418.26:Lumpy:SVtyper:0.145","<DEL>","13",89253466,316,"intergenic",0,"Human",0.259574468,89253782
"11:132083620:<DEL>:314:444.69:Lumpy:SVtyper:0.344","<DEL>","11",132083620,314,NA,0,"Human",0.527659574,132083934
"2:231996182:<DEL>:324:626.45:Lumpy:SVtyper:0.337","<DEL>","2",231996182,324,NA,0,"Human",0.531914894,231996506
"12:121401641:<DEL>:314:341.94:Lumpy:SVtyper:0.199","<DEL>","12",121401641,314,"intergenic",0,"Human",0.370212766,121401955
"19:53616471:<DEL>:318:1698.71:Lumpy:SVtyper:0.475","<DEL>","19",53616471,318,NA,0,"Human",0.672340426,53616789
"6:57257674:<DEL>:295:757.205:Lumpy:SVtyper:0.004","<DEL>","6",57257674,295,NA,0,"Human",0.008510638,57257969
"16:19506320:<DEL>:319:1084.705:Lumpy:SVtyper:0.004","<DEL>","16",19506320,319,NA,0,"Human",0.004255319,19506639
"22:33295767:<DEL>:318:286.64:Lumpy:SVtyper:0.007","<DEL>","22",33295767,318,NA,0,"Human",0.017021277,33296085
"12:120389436:<DEL>:313:341.40:Lumpy:SVtyper:0.004","<DEL>","12",120389436,313,"intergenic",0,"Human",0.008510638,120389749
"9:31042916:<DEL>:275:783.53:Both:Both:0.022","<DEL>","9",31042916,275,"intergenic",0,"Human",0.034042553,31043191
"3:165697675:<DEL>:307:809.96:Lumpy:SVtyper:0.014","<DEL>","3",165697675,307,"intergenic",0,"Human",0.029787234,165697982
"8:3207513:<DEL>:296:845.425:Lumpy:SVtyper:0.011","<DEL>","8",3207513,296,NA,0,"Human",0.017021277,3207809
"2:196031315:<DEL>:305:2831.41:Lumpy:SVtyper:0.014","<DEL>","2",196031315,305,"intergenic",0,"Human",0.012765957,196031620
"18:77184630:<DEL>:292:382.255:Lumpy:SVtyper:0.011","<DEL>","18",77184630,292,NA,0,"Human",0.017021277,77184922
"6:159666771:<DEL>:323:1115.105:Lumpy:SVtyper:0.739","<DEL>","6",159666771,323,NA,0,"Human",0.825531915,159667094
"7:104129516:<DEL>:281:1247.52:Lumpy:SVtyper:0.395","<DEL>","7",104129516,281,NA,0,"Human",0.634042553,104129797
"6:74156163:<DEL>:325:1314.49:Lumpy:SVtyper:0.609","<DEL>","6",74156163,325,NA,0,"Human",0.770212766,74156488
"3:21457504:<DEL>:323:1064.67:Lumpy:SVtyper:0.638","<DEL>","3",21457504,323,"intergenic",0,"Human",0.804255319,21457827
"14:102754157:<DEL>:318:385.075:Lumpy:SVtyper:0.004","<DEL>","14",102754157,318,NA,0,"Human",0.008510638,102754475
"8:2311954:<DEL>:283:348.69:Lumpy:SVtyper:0","<DEL>","8",2311954,283,"intergenic",0,"Human",0.004255319,2312237
"2:85326976:<DEL>:307:316.315:Lumpy:SVtyper:0.007","<DEL>","2",85326976,307,"intergenic",0,"Human",0.008510638,85327283
"10:20667251:<DEL>:320:806.87:Lumpy:SVtyper:0.007","<DEL>","10",20667251,320,"intergenic",0,"Human",0.012765957,20667571
"6:1682794:<DEL>:311:1005.075:Lumpy:SVtyper:0.355","<DEL>","6",1682794,311,NA,0,"Human",0.489361702,1683105
"X:36743044:<DEL>:316:770.055:Lumpy:SVtyper:0.135","<DEL>","X",36743044,316,"intergenic",0,"Human",0.178723404,36743360
"10:26354756:<DEL>:318:509.14:Lumpy:Both:0.373","<DEL>","10",26354756,318,NA,0,"Human",0.574468085,26355074
"1:37009579:<DEL>:301:163.69:Lumpy:SVtyper:0.007","<DEL>","1",37009579,301,"intergenic",0,"Human",0.017021277,37009880
"18:45996153:<DEL>:317:2962.485:Lumpy:SVtyper:0.007","<DEL>","18",45996153,317,"intergenic",0,"Human",0.012765957,45996470
"11:12152549:<DEL>:324:731.89:Lumpy:SVtyper:0.562","<DEL>","11",12152549,324,NA,0,"Human",0.740425532,12152873
"1:234587204:<DEL>:310:684.97:Lumpy:SVtyper:0.413","<DEL>","1",234587204,310,NA,0,"Human",0.646808511,234587514
"18:74297281:<DEL>:316:269.67:Lumpy:SVtyper:0.007","<DEL>","18",74297281,316,"intergenic",0,"Human",0.008510638,74297597
"1:184937043:<DEL>:323:2058.58:Lumpy:SVtyper:0.663","<DEL>","1",184937043,323,NA,0,"Human",0.782978723,184937366
"10:26767952:<DEL>:306:1996.455:Lumpy:SVtyper:0.670","<DEL>","10",26767952,306,NA,0,"Human",0.787234043,26768258
"6:104183197:<DEL>:325:848.39:Lumpy:SVtyper:0.460","<DEL>","6",104183197,325,"intergenic",0,"Human",0.663829787,104183522
"7:62349338:<DEL>:283:431.345:Lumpy:SVtyper:0.014","<DEL>","7",62349338,283,"intergenic",0,"Human",0.021276596,62349621
"5:79557200:<DEL>:314:758.05:Lumpy:SVtyper:0.428","<DEL>","5",79557200,314,"intergenic",0,"Human",0.638297872,79557514
"22:42140479:<DEL>:322:1380.77:Lumpy:SVtyper:0.623","<DEL>","22",42140479,322,NA,0,"Human",0.778723404,42140801
"15:100702592:<DEL>:310:255.375:Lumpy:SVtyper:0.004","<DEL>","15",100702592,310,NA,0,"Human",0.008510638,100702902
"8:131688716:<DEL>:313:553.37:Lumpy:SVtyper:0.127","<DEL>","8",131688716,313,"intergenic",0,"Human",0.234042553,131689029
"7:156140495:<DEL>:289:217.35:Lumpy:SVtyper:0","<DEL>","7",156140495,289,"intergenic",0,"Human",0.004255319,156140784
"2:155891179:<DEL>:316:1005.34:Lumpy:SVtyper:0.257","<DEL>","2",155891179,316,"intergenic",0,"Human",0.485106383,155891495
"5:89860423:<DEL>:321:685.51:Lumpy:SVtyper:0.022","<DEL>","5",89860423,321,NA,0,"Human",0.029787234,89860744
"13:80678314:<DEL>:317:1090.695:Lumpy:SVtyper:0.214","<DEL>","13",80678314,317,"intergenic",0,"Human",0.4,80678631
"1:115043523:<DEL>:312:1275.43:Lumpy:SVtyper:0.257","<DEL>","1",115043523,312,NA,0,"Human",0.425531915,115043835
"2:104839137:<DEL>:307:253.755:Lumpy:SVtyper:0.007","<DEL>","2",104839137,307,"intergenic",0,"Human",0.017021277,104839444
"X:33208584:<DEL>:324:155.195:Lumpy:SVtyper:0.029","<DEL>","X",33208584,324,NA,0,"Human",0.038297872,33208908
"17:12196584:<DEL>:317:2638.58:Lumpy:SVtyper:0.793","<DEL>","17",12196584,317,"intergenic",0,"Human",0.821276596,12196901
"11:93102804:<DEL>:318:528.28:Lumpy:SVtyper:0.007","<DEL>","11",93102804,318,NA,0,"Human",0.017021277,93103122
"3:155410972:<DEL>:325:354.755:Lumpy:SVtyper:0.301","<DEL>","3",155410972,325,NA,0,"Human",0.455319149,155411297
"4:120013804:<DEL>:324:157.475:Lumpy:SVtyper:0.004","<DEL>","4",120013804,324,"intergenic",0,"Human",0.008510638,120014128
"14:35401405:<DEL>:321:1221.36:Lumpy:SVtyper:0.431","<DEL>","14",35401405,321,"intergenic",0,"Human",0.659574468,35401726
"6:154446924:<DEL>:322:1233.22:Lumpy:SVtyper:0.804","<DEL>","6",154446924,322,NA,0,"Human",0.906382979,154447246
"18:76658630:<DEL>:288:432.68:Lumpy:SVtyper:0.029","<DEL>","18",76658630,288,"intergenic",0,"Human",0.055319149,76658918
"11:25609503:<DEL>:300:608.91:Lumpy:SVtyper:0.007","<DEL>","11",25609503,300,"intergenic",0,"Human",0.008510638,25609803
"9:89799096:<DEL>:314:1411.75:Lumpy:SVtyper:0.692","<DEL>","9",89799096,314,"intergenic",0,"Human",0.8,89799410
"13:40028475:<DEL>:322:1025.56:Lumpy:SVtyper:0.420","<DEL>","13",40028475,322,NA,0,"Human",0.612765957,40028797
"2:181925831:<DEL>:322:816.57:Lumpy:SVtyper:0.583","<DEL>","2",181925831,322,NA,0,"Human",0.719148936,181926153
"7:90583933:<DEL>:307:2093.795:Lumpy:SVtyper:0.652","<DEL>","7",90583933,307,NA,0,"Human",0.855319149,90584240
"6:166696486:<DEL>:302:884.93:Lumpy:SVtyper:0.109","<DEL>","6",166696486,302,"intergenic",0,"Human",0.136170213,166696788
"18:73570009:<DEL>:323:551.20:Lumpy:SVtyper:0.395","<DEL>","18",73570009,323,"intergenic",0,"Human",0.608510638,73570332
"3:66049246:<DEL>:314:706.81:Lumpy:SVtyper:0.261","<DEL>","3",66049246,314,"intergenic",0,"Human",0.45106383,66049560
"1:165731213:<DEL>:280:1052.38:Lumpy:SVtyper:0.500","<DEL>","1",165731213,280,NA,0,"Human",0.774468085,165731493
"9:93883364:<DEL>:322:1191.15:Lumpy:SVtyper:0.152","<DEL>","9",93883364,322,"intergenic",0,"Human",0.276595745,93883686
"15:30006675:<DEL>:303:418.80:Lumpy:SVtyper:0.007","<DEL>","15",30006675,303,NA,0,"Human",0.012765957,30006978
"13:23055209:<DEL>:307:249.16:Lumpy:SVtyper:0.018","<DEL>","13",23055209,307,"intergenic",0,"Human",0.034042553,23055516
"11:77403272:<DEL>:322:618.9:Lumpy:SVtyper:0.004","<DEL>","11",77403272,322,NA,0,"Human",0.008510638,77403594
"1:17684765:<DEL>:322:543.02:Lumpy:SVtyper:0.500","<DEL>","1",17684765,322,NA,0,"Human",0.714893617,17685087
"11:17195844:<DEL>:313:611.08:Lumpy:SVtyper:0.007","<DEL>","11",17195844,313,"intergenic",0,"Human",0.008510638,17196157
"8:54971857:<DEL>:314:245.115:Lumpy:SVtyper:0.192","<DEL>","8",54971857,314,NA,0,"Human",0.310638298,54972171
"8:95329670:<DEL>:306:348.41:Lumpy:SVtyper:0.051","<DEL>","8",95329670,306,"intergenic",0,"Human",0.093617021,95329976
"16:12002337:<DEL>:325:1766.365:Lumpy:SVtyper:0.312","<DEL>","16",12002337,325,NA,0,"Human",0.565957447,12002662
"22:45015435:<DEL>:321:633.76:Lumpy:SVtyper:0.007","<DEL>","22",45015435,321,"intergenic",0,"Human",0.008510638,45015756
"3:102810353:<DEL>:314:455.465:Lumpy:SVtyper:0.134","<DEL>","3",102810353,314,"intergenic",0,"Human",0.238297872,102810667
"7:31759525:<DEL>:291:285.045:Lumpy:SVtyper:0.004","<DEL>","7",31759525,291,"intergenic",0,"Human",0.008510638,31759816
"6:19147067:<DUP>:294:839.79:Lumpy:SVtyper:0.007","<DUP>","6",19147067,294,"intergenic",0,"Human",0.012765957,19147361
"7:141113872:<DEL>:319:1032.31:Lumpy:SVtyper:0.486","<DEL>","7",141113872,319,NA,0,"Human",0.663829787,141114191
"9:13840780:<DEL>:304:1095.28:Lumpy:SVtyper:0.007","<DEL>","9",13840780,304,"intergenic",0,"Human",0.012765957,13841084
"11:41007027:<DEL>:322:712.875:Lumpy:SVtyper:0.014","<DEL>","11",41007027,322,NA,0,"Human",0.038297872,41007349
"6:23300366:<DEL>:322:2132.675:Lumpy:SVtyper:0.007","<DEL>","6",23300366,322,"intergenic",0,"Human",0.012765957,23300688
"1:218785920:<DEL>:320:1574.37:Lumpy:SVtyper:0.598","<DEL>","1",218785920,320,"intergenic",0,"Human",0.795744681,218786240
"4:134295544:<DEL>:320:913.92:Lumpy:SVtyper:0.268","<DEL>","4",134295544,320,"intergenic",0,"Human",0.438297872,134295864
"3:24819511:<DEL>:325:780.29:Lumpy:SVtyper:0.011","<DEL>","3",24819511,325,"intergenic",0,"Human",0.017021277,24819836
"8:107511104:<DEL>:325:1071.545:Lumpy:SVtyper:0.007","<DEL>","8",107511104,325,NA,0,"Human",0.012765957,107511429
"11:100267542:<DEL>:309:732.43:Lumpy:SVtyper:0.101","<DEL>","11",100267542,309,"intergenic",0,"Human",0.187234043,100267851
"5:129383551:<DEL>:279:1331.11:Lumpy:SVtyper:0.004","<DEL>","5",129383551,279,NA,0,"Human",0.004255319,129383830
"18:9621904:<DEL>:313:1674.93:Lumpy:SVtyper:0.518","<DEL>","18",9621904,313,"intergenic",0,"Human",0.617021277,9622217
"18:50925984:<DEL>:324:2574.435:Lumpy:SVtyper:0.822","<DEL>","18",50925984,324,NA,0,"Human",0.885106383,50926308
"18:35315623:<DEL>:318:1221.355:Lumpy:SVtyper:0.011","<DEL>","18",35315623,318,"intergenic",0,"Human",0.012765957,35315941
"19:8514411:<DEL>:307:1699.635:Lumpy:SVtyper:0.739","<DEL>","19",8514411,307,NA,0,"Human",0.804255319,8514718
"12:125334398:<DEL>:311:676.88:Lumpy:SVtyper:0.207","<DEL>","12",125334398,311,NA,0,"Human",0.314893617,125334709
"5:25275407:<DEL>:325:963.81:Lumpy:SVtyper:0.116","<DEL>","5",25275407,325,"intergenic",0,"Human",0.195744681,25275732
"1:228024102:<DEL>:312:1783.91:Lumpy:SVtyper:0.478","<DEL>","1",228024102,312,NA,0,"Human",0.761702128,228024414
"14:81539068:<DEL>:320:481.62:Lumpy:SVtyper:0.022","<DEL>","14",81539068,320,NA,0,"Human",0.034042553,81539388
"17:56035753:<DUP>:319:212.35:Lumpy:SVtyper:0.007","<DUP>","17",56035753,319,"intergenic",0,"Human",0.012765957,56036072
"6:91237583:<DEL>:321:814.54:Lumpy:SVtyper:0.565","<DEL>","6",91237583,321,NA,0,"Human",0.761702128,91237904
"12:131048415:<DEL>:282:593.275:Lumpy:SVtyper:0.011","<DEL>","12",131048415,282,"intergenic",0,"Human",0.012765957,131048697
"18:66221319:<DEL>:323:635.89:Lumpy:SVtyper:0.101","<DEL>","18",66221319,323,"intergenic",0,"Human",0.204255319,66221642
"1:28247801:<DEL>:313:2099.14:Lumpy:SVtyper:0.580","<DEL>","1",28247801,313,"intergenic",0,"Human",0.753191489,28248114
"10:1600505:<DEL>:322:162.33:Lumpy:SVtyper:0.004","<DEL>","10",1600505,322,NA,0,"Human",0.008510638,1600827
"2:230003558:<DEL>:277:646.13:Lumpy:SVtyper:0.004","<DEL>","2",230003558,277,NA,0,"Human",0.004255319,230003835
"X:118343005:<DEL>:298:383.46:Lumpy:SVtyper:0.005","<DEL>","X",118343005,298,"intergenic",0,"Human",0.004255319,118343303
"13:83179452:<DEL>:307:227.05:Lumpy:SVtyper:0.428","<DEL>","13",83179452,307,"intergenic",0,"Human",0.655319149,83179759
"12:86523322:<DEL>:320:1256.23:Lumpy:SVtyper:0.424","<DEL>","12",86523322,320,NA,0,"Human",0.65106383,86523642
"7:158156740:<DEL>:304:412.04:Lumpy:SVtyper:0.004","<DEL>","7",158156740,304,NA,0,"Human",0.004255319,158157044
"6:50765965:<DEL>:311:883.315:Lumpy:SVtyper:0.399","<DEL>","6",50765965,311,"intergenic",0,"Human",0.595744681,50766276
"15:79911587:<DEL>:312:1157.71:Lumpy:SVtyper:0.007","<DEL>","15",79911587,312,"intergenic",0,"Human",0.008510638,79911899
"6:149999138:<DEL>:282:605.82:Lumpy:SVtyper:0.004","<DEL>","6",149999138,282,NA,0,"Human",0.008510638,149999420
"8:42572233:<DEL>:321:191.19:Lumpy:SVtyper:0.004","<DEL>","8",42572233,321,NA,0,"Human",0.004255319,42572554
"2:188215728:<DEL>:307:1423.33:Lumpy:SVtyper:0.007","<DEL>","2",188215728,307,NA,0,"Human",0.012765957,188216035
"12:95344058:<DEL>:310:873.47:Lumpy:SVtyper:0.344","<DEL>","12",95344058,310,"intergenic",0,"Human",0.561702128,95344368
"9:4346660:<DEL>:311:2325.18:Lumpy:SVtyper:0.812","<DEL>","9",4346660,311,"intergenic",0,"Human",0.829787234,4346971
"1:97334404:<DEL>:277:338.96:Lumpy:SVtyper:0.004","<DEL>","1",97334404,277,"intergenic",0,"Human",0.004255319,97334681
"4:186198866:<DEL>:319:1348.055:Lumpy:SVtyper:0.351","<DEL>","4",186198866,319,NA,0,"Human",0.553191489,186199185
"20:55606710:<DEL>:307:1024.75:Lumpy:SVtyper:0.007","<DEL>","20",55606710,307,"intergenic",0,"Human",0.008510638,55607017
"1:240617002:<DEL>:324:1139.785:Lumpy:SVtyper:0.591","<DEL>","1",240617002,324,NA,0,"Human",0.774468085,240617326
"3:7347026:<DEL>:298:701.95:Lumpy:SVtyper:0.004","<DEL>","3",7347026,298,NA,0,"Human",0.008510638,7347324
"1:240617002:<DEL>:324:613.77:Lumpy:SVtyper:0.007","<DEL>","1",240617002,324,NA,0,"Human",0.012765957,240617326
"4:110498743:<DEL>:325:666.35:Lumpy:SVtyper:0.007","<DEL>","4",110498743,325,NA,0,"Human",0.012765957,110499068
"12:41659825:<DEL>:317:2542.51:Lumpy:SVtyper:0.652","<DEL>","12",41659825,317,NA,0,"Human",0.774468085,41660142
"6:17472271:<DEL>:313:837.465:Lumpy:SVtyper:0.170","<DEL>","6",17472271,313,NA,0,"Human",0.25106383,17472584
"X:71123222:<DEL>:317:2021.725:Lumpy:SVtyper:0.014","<DEL>","X",71123222,317,"intergenic",0,"Human",0.012765957,71123539
"1:24402988:<DEL>:317:275.86:Lumpy:SVtyper:0.315","<DEL>","1",24402988,317,NA,0,"Human",0.565957447,24403305
"12:128037978:<DEL>:317:1164.455:Lumpy:SVtyper:0.301","<DEL>","12",128037978,317,"intergenic",0,"Human",0.485106383,128038295
"21:44612104:<DEL>:279:919.99:Lumpy:SVtyper:0.004","<DEL>","21",44612104,279,"intergenic",0,"Human",0.008510638,44612383
"5:90574691:<DEL>:296:1577.75:Lumpy:SVtyper:0.645","<DEL>","5",90574691,296,"intergenic",0,"Human",0.757446809,90574987
"1:115796900:<DEL>:284:364.855:Lumpy:SVtyper:0.464","<DEL>","1",115796900,284,"intergenic",0,"Human",0.689361702,115797184
"6:95335623:<DEL>:305:606.23:Lumpy:SVtyper:0.004","<DEL>","6",95335623,305,"intergenic",0,"Human",0.008510638,95335928
"16:80468633:<DEL>:313:1574.71:Lumpy:SVtyper:0.370","<DEL>","16",80468633,313,"intergenic",0,"Human",0.54893617,80468946
"6:72571434:<DEL>:321:1221.9:Lumpy:SVtyper:0.007","<DEL>","6",72571434,321,"intergenic",0,"Human",0.012765957,72571755
"2:235919410:<DUP>:292:391.76:Lumpy:SVtyper:0.145","<DUP>","2",235919410,292,NA,0,"Human",0.314893617,235919702
"5:24091615:<DEL>:325:614.31:Lumpy:SVtyper:0.500","<DEL>","5",24091615,325,"intergenic",0,"Human",0.714893617,24091940
"10:54860810:<DEL>:319:1061.71:Lumpy:SVtyper:0.681","<DEL>","10",54860810,319,"intergenic",0,"Human",0.787234043,54861129
"2:56850111:<DEL>:323:1018.86:Lumpy:SVtyper:0.384","<DEL>","2",56850111,323,"intergenic",0,"Human",0.587234043,56850434
"X:144475966:<DEL>:321:1083.25:Both:Both:0.005","<DEL>","X",144475966,321,"intergenic",0,"Human",0.008510638,144476287
"7:101334199:<DEL>:320:588.16:Lumpy:SVtyper:0.007","<DEL>","7",101334199,320,"intergenic",0,"Human",0.012765957,101334519
"1:11759724:<DEL>:312:703.035:Lumpy:SVtyper:0.004","<DEL>","1",11759724,312,NA,0,"Human",0.008510638,11760036
"5:164366309:<DEL>:311:1591.78:Lumpy:SVtyper:0.453","<DEL>","5",164366309,311,"intergenic",0,"Human",0.706382979,164366620
"13:76963997:<DEL>:280:766.41:Lumpy:SVtyper:0.054","<DEL>","13",76963997,280,"intergenic",0,"Human",0.089361702,76964277
"13:41271118:<DEL>:312:854.86:Lumpy:SVtyper:0.297","<DEL>","13",41271118,312,"intergenic",0,"Human",0.468085106,41271430
"20:3037876:<DEL>:316:994.81:Lumpy:SVtyper:0.583","<DEL>","20",3037876,316,"intergenic",0,"Human",0.740425532,3038192
"1:217917515:<DEL>:313:952.22:Lumpy:SVtyper:0.391","<DEL>","1",217917515,313,NA,0,"Human",0.608510638,217917828
"5:144994873:<DEL>:316:471.92:Lumpy:SVtyper:0.080","<DEL>","5",144994873,316,"intergenic",0,"Human",0.140425532,144995189
"2:235812270:<DEL>:311:837.06:Lumpy:SVtyper:0.120","<DEL>","2",235812270,311,"intergenic",0,"Human",0.221276596,235812581
"6:130959403:<DEL>:320:1496.785:Lumpy:SVtyper:0.138","<DEL>","6",130959403,320,"intergenic",0,"Human",0.255319149,130959723
"12:55660539:<DEL>:308:676.47:Lumpy:SVtyper:0.004","<DEL>","12",55660539,308,"intergenic",0,"Human",0.008510638,55660847
"21:46371795:<DEL>:317:524.51:Lumpy:SVtyper:0.004","<DEL>","21",46371795,317,NA,0,"Human",0.004255319,46372112
"4:183046034:<DEL>:299:709.78:Lumpy:SVtyper:0.004","<DEL>","4",183046034,299,"intergenic",0,"Human",0.008510638,183046333
"10:59053470:<DEL>:321:424.99:Lumpy:SVtyper:0.011","<DEL>","10",59053470,321,"intergenic",0,"Human",0.017021277,59053791
"10:15532465:<DEL>:310:690.36:Lumpy:SVtyper:0.007","<DEL>","10",15532465,310,"intergenic",0,"Human",0.012765957,15532775
"18:76169470:<DEL>:322:523.98:Lumpy:SVtyper:0.257","<DEL>","18",76169470,322,"intergenic",0,"Human",0.45106383,76169792
"9:7534446:<DEL>:280:686.445:Lumpy:SVtyper:0.004","<DEL>","9",7534446,280,"intergenic",0,"Human",0.008510638,7534726
"X:105191165:<DEL>:303:301.22:Lumpy:SVtyper:0.010","<DEL>","X",105191165,303,NA,0,"Human",0.012765957,105191468
"2:232114372:<DEL>:301:536.91:Lumpy:SVtyper:0.004","<DEL>","2",232114372,301,NA,0,"Human",0.008510638,232114673
"13:25645192:<DEL>:319:1806.75:Lumpy:SVtyper:0.261","<DEL>","13",25645192,319,"intergenic",0,"Human",0.463829787,25645511
"9:36423655:<DEL>:316:1781.13:Lumpy:SVtyper:0.453","<DEL>","9",36423655,316,"intergenic",0,"Human",0.65106383,36423971
"4:185665772:<DEL>:318:739.44:Both:Both:0.007","<DEL>","4",185665772,318,"intergenic",0,"Human",0.021276596,185666090
"10:70272101:<DEL>:322:343.28:Lumpy:SVtyper:0.167","<DEL>","10",70272101,322,NA,0,"Human",0.289361702,70272423
"1:245487152:<DEL>:276:316.715:Lumpy:SVtyper:0.004","<DEL>","1",245487152,276,NA,0,"Human",0.004255319,245487428
"1:83042645:<DEL>:320:522.36:Lumpy:SVtyper:0.018","<DEL>","1",83042645,320,"intergenic",0,"Human",0.034042553,83042965
"13:24069358:<DEL>:307:572.645:Lumpy:SVtyper:0.083","<DEL>","13",24069358,307,"intergenic",0,"Human",0.14893617,24069665
"11:43909596:<DEL>:306:1028.00:Lumpy:SVtyper:0.514","<DEL>","11",43909596,306,NA,0,"Human",0.808510638,43909902
"3:143624037:<DEL>:318:513.18:Lumpy:SVtyper:0.004","<DEL>","3",143624037,318,"intergenic",0,"Human",0.004255319,143624355
"12:22245417:<DEL>:295:810.63:Lumpy:SVtyper:0.004","<DEL>","12",22245417,295,"intergenic",0,"Human",0.008510638,22245712
"18:71273403:<DEL>:321:1102.155:Lumpy:SVtyper:0.007","<DEL>","18",71273403,321,"intergenic",0,"Human",0.008510638,71273724
"7:12058713:<DEL>:324:490.93:Lumpy:SVtyper:0.007","<DEL>","7",12058713,324,"intergenic",0,"Human",0.012765957,12059037
"5:78277729:<DEL>:319:458.16:Lumpy:SVtyper:0.007","<DEL>","5",78277729,319,NA,0,"Human",0.012765957,78278048
"X:142181809:<DEL>:275:536.09:Lumpy:SVtyper:0.010","<DEL>","X",142181809,275,"intergenic",0,"Human",0.017021277,142182084
"14:71320964:<DEL>:293:685.77:Lumpy:SVtyper:0.014","<DEL>","14",71320964,293,"intergenic",0,"Human",0.029787234,71321257
"1:223060822:<DEL>:319:697.37:Lumpy:SVtyper:0.094","<DEL>","1",223060822,319,NA,0,"Human",0.178723404,223061141
"3:99037449:<DEL>:312:602.98:Lumpy:SVtyper:0.007","<DEL>","3",99037449,312,"intergenic",0,"Human",0.012765957,99037761
"19:16668768:<DEL>:285:318.74:Lumpy:SVtyper:0.004","<DEL>","19",16668768,285,NA,0,"Human",0.004255319,16669053
"11:93102804:<DEL>:318:2441.32:Lumpy:SVtyper:0.645","<DEL>","11",93102804,318,NA,0,"Human",0.778723404,93103122
"12:1864013:<DEL>:315:1168.77:Lumpy:SVtyper:0.254","<DEL>","12",1864013,315,NA,0,"Human",0.468085106,1864328
"13:59044764:<DEL>:316:110.28:Lumpy:SVtyper:0.004","<DEL>","13",59044764,316,"intergenic",0,"Human",0.004255319,59045080
"12:13164464:<DUP>:295:799.99:Lumpy:SVtyper:0.475","<DUP>","12",13164464,295,"intergenic",0,"Human",0.787234043,13164759
"4:189793244:<DEL>:319:295.56:Lumpy:SVtyper:0.543","<DEL>","4",189793244,319,"intergenic",0,"Human",0.680851064,189793563
"4:121407658:<DEL>:323:929.425:Lumpy:SVtyper:0.203","<DEL>","4",121407658,323,"intergenic",0,"Human",0.327659574,121407981
"20:33119107:<DUP>:312:280.745:Lumpy:SVtyper:0.004","<DUP>","20",33119107,312,NA,0,"Human",0.008510638,33119419
"1:13999726:<DEL>:311:433.355:Lumpy:SVtyper:0.025","<DEL>","1",13999726,311,"intergenic",0,"Human",0.05106383,14000037
"4:133819612:<DEL>:323:908.395:Lumpy:SVtyper:0.525","<DEL>","4",133819612,323,"intergenic",0,"Human",0.765957447,133819935
"5:7221933:<DEL>:321:712.74:Lumpy:SVtyper:0.504","<DEL>","5",7221933,321,"intergenic",0,"Human",0.736170213,7222254
"13:101242064:<DEL>:317:725.68:Both:Both:0.022","<DEL>","13",101242064,317,"intergenic",0,"Human",0.05106383,101242381
"5:16535667:<DEL>:285:580.59:Lumpy:SVtyper:0","<DEL>","5",16535667,285,NA,0,"Human",0.004255319,16535952
"8:69587269:<DEL>:325:342.74:Lumpy:SVtyper:0.004","<DEL>","8",69587269,325,NA,0,"Human",0.004255319,69587594
"1:73753595:<DEL>:321:2412.01:Lumpy:SVtyper:0.764","<DEL>","1",73753595,321,"intergenic",0,"Human",0.846808511,73753916
"5:57859461:<DEL>:315:348.545:Lumpy:SVtyper:0.007","<DEL>","5",57859461,315,"intergenic",0,"Human",0.008510638,57859776
"12:128932247:<DEL>:299:897.74:Lumpy:SVtyper:0.112","<DEL>","12",128932247,299,NA,0,"Human",0.242553191,128932546
"19:50907533:<DEL>:305:297.04:Lumpy:SVtyper:0.004","<DEL>","19",50907533,305,NA,0,"Human",0.008510638,50907838
"19:4036820:<DEL>:286:545.145:Lumpy:SVtyper:0.004","<DEL>","19",4036820,286,NA,0,"Human",0.008510638,4037106
"3:189955410:<DEL>:301:553.905:Lumpy:SVtyper:0.004","<DEL>","3",189955410,301,"intergenic",0,"Human",0.004255319,189955711
"11:131502567:<DEL>:305:1246.69:Lumpy:SVtyper:0.004","<DEL>","11",131502567,305,NA,0,"Human",0.008510638,131502872
"18:69896761:<DEL>:316:798.09:Lumpy:SVtyper:0.337","<DEL>","18",69896761,316,"intergenic",0,"Human",0.570212766,69897077
"2:223797367:<DEL>:318:1667.915:Lumpy:SVtyper:0.362","<DEL>","2",223797367,318,NA,0,"Human",0.4,223797685
"6:51256296:<DEL>:316:774.50:Lumpy:SVtyper:0.438","<DEL>","6",51256296,316,"intergenic",0,"Human",0.629787234,51256612
"7:137455272:<DEL>:307:470.715:Lumpy:SVtyper:0.004","<DEL>","7",137455272,307,NA,0,"Human",0.004255319,137455579
"19:837839:<DEL>:305:166.38:Lumpy:SVtyper:0.199","<DEL>","19",837839,305,"intergenic",0,"Human",0.327659574,838144
"3:82936657:<DEL>:301:906.91:Lumpy:SVtyper:0.051","<DEL>","3",82936657,301,"intergenic",0,"Human",0.063829787,82936958
"18:71273403:<DEL>:321:749.97:Lumpy:SVtyper:0.453","<DEL>","18",71273403,321,"intergenic",0,"Human",0.672340426,71273724
"4:190253845:<DEL>:322:402.07:Both:Both:0.007","<DEL>","4",190253845,322,"intergenic",0,"Human",0.021276596,190254167
"10:21691368:<DEL>:283:759.535:Lumpy:SVtyper:0.004","<DEL>","10",21691368,283,"intergenic",0,"Human",0.008510638,21691651
"17:68150239:<DEL>:308:574.93:Lumpy:SVtyper:0.130","<DEL>","17",68150239,308,"intergenic",0,"Human",0.263829787,68150547
"1:220285463:<DEL>:320:775.985:Lumpy:SVtyper:0.268","<DEL>","1",220285463,320,NA,0,"Human",0.468085106,220285783
"19:37046190:<DEL>:316:1477.68:Lumpy:SVtyper:0.446","<DEL>","19",37046190,316,NA,0,"Human",0.65106383,37046506
"18:35315623:<DEL>:318:2109.84:Lumpy:SVtyper:0.598","<DEL>","18",35315623,318,"intergenic",0,"Human",0.761702128,35315941
"10:68241213:<DEL>:309:928.21:Lumpy:SVtyper:0.025","<DEL>","10",68241213,309,NA,0,"Human",0.05106383,68241522
"9:73463610:<DEL>:316:1352.96:Lumpy:SVtyper:0.417","<DEL>","9",73463610,316,NA,0,"Human",0.617021277,73463926
"14:46577930:<DEL>:320:367.02:Lumpy:SVtyper:0.007","<DEL>","14",46577930,320,"intergenic",0,"Human",0.012765957,46578250
"8:117591471:<DEL>:295:865.655:Lumpy:SVtyper:0.011","<DEL>","8",117591471,295,"intergenic",0,"Human",0.012765957,117591766
"3:100306754:<DEL>:320:802.27:Lumpy:SVtyper:0.141","<DEL>","3",100306754,320,"intergenic",0,"Human",0.289361702,100307074
"2:75803363:<DEL>:322:1415.26:Lumpy:SVtyper:0.007","<DEL>","2",75803363,322,"intergenic",0,"Human",0.017021277,75803685
"3:145931904:<DEL>:312:2013.22:Lumpy:SVtyper:0.547","<DEL>","3",145931904,312,NA,0,"Human",0.736170213,145932216
"9:7371804:<DEL>:313:283.42:Lumpy:SVtyper:0.004","<DEL>","9",7371804,313,"intergenic",0,"Human",0.004255319,7372117
"2:158719092:<DEL>:311:458.44:Lumpy:SVtyper:0.007","<DEL>","2",158719092,311,NA,0,"Human",0.012765957,158719403
"22:18099520:<DEL>:310:310.785:Lumpy:SVtyper:0.246","<DEL>","22",18099520,310,NA,0,"Human",0.421276596,18099830
"7:14449046:<DEL>:321:935.77:Lumpy:SVtyper:0.007","<DEL>","7",14449046,321,NA,0,"Human",0.012765957,14449367
"20:62123517:<DUP>:318:571.635:Lumpy:SVtyper:0.279","<DUP>","20",62123517,318,NA,0,"Human",0.493617021,62123835
"15:24207061:<DEL>:309:624.28:Lumpy:SVtyper:0.373","<DEL>","15",24207061,309,"intergenic",0,"Human",0.574468085,24207370
"16:70553012:<DEL>:320:370.79:Lumpy:SVtyper:0.377","<DEL>","16",70553012,320,NA,0,"Human",0.570212766,70553332
"4:8771106:<DEL>:308:307.41:Lumpy:SVtyper:0.004","<DEL>","4",8771106,308,"intergenic",0,"Human",0.004255319,8771414
"3:196756965:<DEL>:325:465.18:Lumpy:SVtyper:0.069","<DEL>","3",196756965,325,NA,0,"Human",0.106382979,196757290
"6:157957847:<DEL>:307:2319.645:Lumpy:SVtyper:0.344","<DEL>","6",157957847,307,NA,0,"Human",0.514893617,157958154
"10:100223294:<DUP>:294:107.545:Lumpy:SVtyper:0.004","<DUP>","10",100223294,294,NA,0,"Human",0.008510638,100223588
"11:56407949:<DEL>:317:1585.96:Lumpy:SVtyper:0.062","<DEL>","11",56407949,317,NA,0,"Human",0.131914894,56408266
"21:46795763:<DEL>:276:233.79:Lumpy:SVtyper:0.004","<DEL>","21",46795763,276,"intergenic",0,"Human",0.004255319,46796039
"4:150951032:<DEL>:322:1509.38:Lumpy:SVtyper:0.739","<DEL>","4",150951032,322,"intergenic",0,"Human",0.808510638,150951354
"10:49917167:<DEL>:323:2393.39:Lumpy:SVtyper:0.812","<DEL>","10",49917167,323,NA,0,"Human",0.855319149,49917490
"21:42402892:<DEL>:321:562.26:Lumpy:SVtyper:0.014","<DEL>","21",42402892,321,"intergenic",0,"Human",0.021276596,42403213
"17:79334807:<DEL>:298:619.17:Lumpy:SVtyper:0.014","<DEL>","17",79334807,298,"intergenic",0,"Human",0.034042553,79335105
"9:6999383:<DEL>:307:2176.76:Lumpy:SVtyper:0.746","<DEL>","9",6999383,307,NA,0,"Human",0.770212766,6999690
"10:117692554:<DUP>:322:625.845:Lumpy:SVtyper:0.004","<DUP>","10",117692554,322,NA,0,"Human",0.008510638,117692876
"19:55872835:<DEL>:325:349.09:Lumpy:SVtyper:0.022","<DEL>","19",55872835,325,NA,0,"Human",0.038297872,55873160
"11:381270:<DEL>:291:219.11:Lumpy:SVtyper:0.036","<DEL>","11",381270,291,NA,0,"Human",0.068085106,381561
"7:79165331:<DEL>:310:945.74:Lumpy:SVtyper:0.025","<DEL>","7",79165331,310,"intergenic",0,"Human",0.046808511,79165641
"1:180292998:<DEL>:324:350.83:Lumpy:SVtyper:0.007","<DEL>","1",180292998,324,NA,0,"Human",0.012765957,180293322
"5:33200863:<DEL>:313:2767.99:Lumpy:SVtyper:0.011","<DEL>","5",33200863,313,"intergenic",0,"Human",0.012765957,33201176
"X:52961287:<DEL>:322:1140.73:Lumpy:SVtyper:0.087","<DEL>","X",52961287,322,"intergenic",0,"Human",0.144680851,52961609
"1:158050714:<DEL>:325:452.095:Lumpy:SVtyper:0.207","<DEL>","1",158050714,325,NA,0,"Human",0.357446809,158051039
"6:163690700:<DEL>:294:151.685:Lumpy:SVtyper:0.004","<DEL>","6",163690700,294,NA,0,"Human",0.004255319,163690994
"14:47434123:<DEL>:312:520.72:Lumpy:SVtyper:0.065","<DEL>","14",47434123,312,NA,0,"Human",0.114893617,47434435
"4:134141603:<DEL>:309:230.28:Lumpy:SVtyper:0.007","<DEL>","4",134141603,309,"intergenic",0,"Human",0.012765957,134141912
"18:59728481:<DEL>:281:659.07:Lumpy:SVtyper:0.004","<DEL>","18",59728481,281,NA,0,"Human",0.004255319,59728762
"17:210517:<DEL>:307:1713.645:Lumpy:SVtyper:0.601","<DEL>","17",210517,307,"intergenic",0,"Human",0.74893617,210824
"1:91624776:<DEL>:283:1980.41:Both:Both:0.014","<DEL>","1",91624776,283,"intergenic",0,"Human",0.012765957,91625059
"10:118664420:<DEL>:320:724.06:Lumpy:SVtyper:0.004","<DEL>","10",118664420,320,NA,0,"Human",0.004255319,118664740
"12:54245413:<DEL>:289:227.58:Lumpy:SVtyper:0.674","<DEL>","12",54245413,289,"intergenic",0,"Human",0.821276596,54245702
"8:6587837:<DEL>:321:1062.51:Lumpy:SVtyper:0.007","<DEL>","8",6587837,321,NA,0,"Human",0.012765957,6588158
"9:5434292:<DEL>:305:395.34:Lumpy:SVtyper:0.004","<DEL>","9",5434292,305,NA,0,"Human",0.004255319,5434597
"7:103856435:<DEL>:318:609.325:Lumpy:SVtyper:0.174","<DEL>","7",103856435,318,"intergenic",0,"Human",0.340425532,103856753
"4:76479674:<DEL>:310:660.56:Lumpy:SVtyper:0.007","<DEL>","4",76479674,310,"intergenic",0,"Human",0.008510638,76479984
"2:36955664:<DEL>:316:1395.835:Lumpy:SVtyper:0.471","<DEL>","2",36955664,316,NA,0,"Human",0.757446809,36955980
"14:104681405:<DUP>:275:130.40:Lumpy:SVtyper:0.007","<DUP>","14",104681405,275,"intergenic",0,"Human",0.012765957,104681680
"6:104183197:<DEL>:325:223.27:Lumpy:SVtyper:0.007","<DEL>","6",104183197,325,"intergenic",0,"Human",0.012765957,104183522
"5:73648986:<DEL>:318:1543.48:Lumpy:SVtyper:0.663","<DEL>","5",73648986,318,"intergenic",0,"Human",0.787234043,73649304
"20:60526296:<DEL>:305:687.40:Lumpy:SVtyper:0.395","<DEL>","20",60526296,305,"intergenic",0,"Human",0.553191489,60526601
"15:71198369:<DEL>:290:497.135:Lumpy:SVtyper:0.004","<DEL>","15",71198369,290,NA,0,"Human",0.008510638,71198659
"2:60197892:<DEL>:314:1042.83:Lumpy:SVtyper:0.040","<DEL>","2",60197892,314,"intergenic",0,"Human",0.076595745,60198206
"19:51457469:<DEL>:322:695.22:Lumpy:SVtyper:0.040","<DEL>","19",51457469,322,"intergenic",0,"Human",0.080851064,51457791
"8:92712198:<DEL>:325:1203.085:Lumpy:SVtyper:0.014","<DEL>","8",92712198,325,"intergenic",0,"Human",0.021276596,92712523
"20:37139263:<DEL>:313:695.76:Lumpy:SVtyper:0.025","<DEL>","20",37139263,313,NA,0,"Human",0.055319149,37139576
"19:31017337:<DEL>:316:390.485:Lumpy:SVtyper:0.091","<DEL>","19",31017337,316,NA,0,"Human",0.170212766,31017653
"6:170206136:<DEL>:282:559.985:Lumpy:SVtyper:0.080","<DEL>","6",170206136,282,"intergenic",0,"Human",0.131914894,170206418
"2:1428463:<DEL>:296:153.97:Lumpy:SVtyper:0.014","<DEL>","2",1428463,296,NA,0,"Human",0.029787234,1428759
"6:11903441:<DEL>:312:3654.435:Lumpy:SVtyper:0.754","<DEL>","6",11903441,312,"intergenic",0,"Human",0.821276596,11903753
"8:17265608:<DEL>:324:722.32:Lumpy:SVtyper:0.413","<DEL>","8",17265608,324,NA,0,"Human",0.608510638,17265932
"8:61204996:<DEL>:317:870.76:Lumpy:SVtyper:0.293","<DEL>","8",61204996,317,"intergenic",0,"Human",0.480851064,61205313
"19:6653375:<DEL>:296:526.39:Lumpy:SVtyper:0.004","<DEL>","19",6653375,296,"intergenic",0,"Human",0.004255319,6653671
"1:185374905:<DEL>:299:395.33:Lumpy:SVtyper:0.004","<DEL>","1",185374905,299,"intergenic",0,"Human",0.004255319,185375204
"15:67083772:<DEL>:298:850.27:Lumpy:SVtyper:0.025","<DEL>","15",67083772,298,"intergenic",0,"Human",0.042553191,67084070
"9:124411495:<DEL>:302:810.10:Lumpy:SVtyper:0.236","<DEL>","9",124411495,302,NA,0,"Human",0.421276596,124411797
"6:77920104:<DEL>:311:1407.98:Lumpy:SVtyper:0.572","<DEL>","6",77920104,311,"intergenic",0,"Human",0.761702128,77920415
"14:50192050:<DUP>:310:397.97:Lumpy:SVtyper:0.395","<DUP>","14",50192050,310,NA,0,"Human",0.795744681,50192360
"6:72571434:<DEL>:321:2196.86:Lumpy:SVtyper:0.656","<DEL>","6",72571434,321,"intergenic",0,"Human",0.808510638,72571755
"6:123763422:<DEL>:305:852.57:Lumpy:SVtyper:0.062","<DEL>","6",123763422,305,NA,0,"Human",0.09787234,123763727
"5:112881421:<DEL>:320:582.49:Lumpy:SVtyper:0.333","<DEL>","5",112881421,320,NA,0,"Human",0.54893617,112881741
"1:77100367:<DEL>:283:1243.46:Lumpy:SVtyper:0.319","<DEL>","1",77100367,283,"intergenic",0,"Human",0.531914894,77100650
"8:135156701:<DEL>:319:585.71:Both:Both:0.029","<DEL>","8",135156701,319,"intergenic",0,"Human",0.042553191,135157020
"7:52094960:<DEL>:315:3111.835:Lumpy:SVtyper:0.768","<DEL>","7",52094960,315,"intergenic",0,"Human",0.812765957,52095275
"19:21701359:<DEL>:315:142.08:Lumpy:SVtyper:0.072","<DEL>","19",21701359,315,NA,0,"Human",0.153191489,21701674
"12:120858988:<DEL>:297:343.42:Lumpy:SVtyper:0.029","<DEL>","12",120858988,297,"intergenic",0,"Human",0.046808511,120859285
"5:25275407:<DEL>:325:831:Lumpy:SVtyper:0.004","<DEL>","5",25275407,325,"intergenic",0,"Human",0.008510638,25275732
"11:2942720:<DEL>:320:180.675:Lumpy:SVtyper:0.007","<DEL>","11",2942720,320,NA,0,"Human",0.012765957,2943040
"19:39233904:<DEL>:277:455.2:Lumpy:SVtyper:0.004","<DEL>","19",39233904,277,NA,0,"Human",0.008510638,39234181
"1:4436054:<DEL>:296:659.62:Lumpy:SVtyper:0.007","<DEL>","1",4436054,296,"intergenic",0,"Human",0.012765957,4436350
"2:117059339:<DEL>:323:872.52:Lumpy:SVtyper:0.109","<DEL>","2",117059339,323,"intergenic",0,"Human",0.208510638,117059662
"3:36108121:<DEL>:318:910.015:Lumpy:SVtyper:0.500","<DEL>","3",36108121,318,"intergenic",0,"Human",0.70212766,36108439
"3:82936657:<DEL>:301:2167.36:Lumpy:SVtyper:0.496","<DEL>","3",82936657,301,"intergenic",0,"Human",0.668085106,82936958
"1:40441781:<DEL>:309:292.59:Lumpy:SVtyper:0.004","<DEL>","1",40441781,309,"intergenic",0,"Human",0.008510638,40442090
"8:19524265:<DEL>:283:341.265:Lumpy:SVtyper:0.004","<DEL>","8",19524265,283,NA,0,"Human",0.008510638,19524548
"18:74365365:<DEL>:306:1078.56:Lumpy:SVtyper:0.243","<DEL>","18",74365365,306,"intergenic",0,"Human",0.412765957,74365671
"X:154059783:<DEL>:275:710.83:Lumpy:SVtyper:0.005","<DEL>","X",154059783,275,NA,0,"Human",0.008510638,154060058
"2:113843610:<DEL>:305:648.03:Lumpy:SVtyper:0.011","<DEL>","2",113843610,305,"intergenic",0,"Human",0.021276596,113843915
"6:106928836:<DEL>:316:323.875:Lumpy:SVtyper:0.004","<DEL>","6",106928836,316,"intergenic",0,"Human",0.004255319,106929152
"17:63496069:<DUP>:316:430.62:Lumpy:SVtyper:0.007","<DUP>","17",63496069,316,"intergenic",0,"Human",0.017021277,63496385
"5:99759471:<DEL>:318:478.93:Lumpy:SVtyper:0.007","<DEL>","5",99759471,318,"intergenic",0,"Human",0.012765957,99759789
"20:32335129:<DEL>:321:433.63:Lumpy:SVtyper:0.004","<DEL>","20",32335129,321,NA,0,"Human",0.004255319,32335450
"1:43008204:<DEL>:323:2019.32:Lumpy:SVtyper:0.004","<DEL>","1",43008204,323,NA,0,"Human",0.004255319,43008527
"7:90022146:<DEL>:317:603.52:Lumpy:SVtyper:0.149","<DEL>","7",90022146,317,"intergenic",0,"Human",0.272340426,90022463
"8:118223531:<DEL>:280:915.675:Lumpy:SVtyper:0.007","<DEL>","8",118223531,280,"intergenic",0,"Human",0.021276596,118223811
"12:4467010:<DEL>:317:467.07:Lumpy:SVtyper:0.004","<DEL>","12",4467010,317,NA,0,"Human",0.004255319,4467327
"17:79577695:<DEL>:323:762.63:Lumpy:SVtyper:0.464","<DEL>","17",79577695,323,NA,0,"Human",0.655319149,79578018
"X:4904711:<DEL>:315:512.10:Both:Both:0.010","<DEL>","X",4904711,315,"intergenic",0,"Human",0.012765957,4905026
"10:61365490:<DEL>:319:409.215:Lumpy:SVtyper:0.040","<DEL>","10",61365490,319,"intergenic",0,"Human",0.059574468,61365809
"3:148566797:<DEL>:318:2132.105:Lumpy:SVtyper:0.011","<DEL>","3",148566797,318,NA,0,"Human",0.012765957,148567115
"10:49917167:<DEL>:323:635.08:Lumpy:SVtyper:0.033","<DEL>","10",49917167,323,NA,0,"Human",0.063829787,49917490
"7:13242585:<DEL>:296:609.19:Lumpy:SVtyper:0.007","<DEL>","7",13242585,296,"intergenic",0,"Human",0.008510638,13242881
"17:5933607:<DEL>:317:1034.46:Lumpy:SVtyper:0.518","<DEL>","17",5933607,317,"intergenic",0,"Human",0.731914894,5933924
"2:104186938:<DEL>:309:585.445:Lumpy:SVtyper:0.083","<DEL>","2",104186938,309,"intergenic",0,"Human",0.144680851,104187247
"5:114731313:<DEL>:318:1537.765:Lumpy:SVtyper:0.761","<DEL>","5",114731313,318,"intergenic",0,"Human",0.825531915,114731631
"1:71741320:<DEL>:310:1770.185:Lumpy:SVtyper:0.804","<DEL>","1",71741320,310,"intergenic",0,"Human",0.829787234,71741630
"11:87918549:<DEL>:317:673.37:Lumpy:SVtyper:0.417","<DEL>","11",87918549,317,"intergenic",0,"Human",0.617021277,87918866
"4:44319238:<DEL>:321:787.72:Lumpy:SVtyper:0.004","<DEL>","4",44319238,321,NA,0,"Human",0.008510638,44319559
"12:117308970:<DEL>:289:325.485:Lumpy:SVtyper:0.004","<DEL>","12",117308970,289,NA,0,"Human",0.008510638,117309259
"7:14910428:<DEL>:318:1766.105:Lumpy:SVtyper:0.649","<DEL>","7",14910428,318,"intergenic",0,"Human",0.842553191,14910746
"16:25623563:<DEL>:307:448.32:Lumpy:SVtyper:0.036","<DEL>","16",25623563,307,"intergenic",0,"Human",0.080851064,25623870
"10:72678320:<DEL>:295:817.39:Lumpy:SVtyper:0.040","<DEL>","10",72678320,295,"intergenic",0,"Human",0.063829787,72678615
"7:19534632:<DEL>:282:316.595:Lumpy:SVtyper:0.007","<DEL>","7",19534632,282,"intergenic",0,"Human",0.012765957,19534914
"3:155498779:<DEL>:283:607.155:Lumpy:SVtyper:0.004","<DEL>","3",155498779,283,NA,0,"Human",0.008510638,155499062
"15:58596498:<DEL>:321:1037.44:Lumpy:SVtyper:0.449","<DEL>","15",58596498,321,"intergenic",0,"Human",0.693617021,58596819
"8:121854751:<DEL>:318:1731.59:Lumpy:SVtyper:0.333","<DEL>","8",121854751,318,"intergenic",0,"Human",0.536170213,121855069
"2:142788890:<DEL>:302:954.91:Lumpy:SVtyper:0.007","<DEL>","2",142788890,302,NA,0,"Human",0.017021277,142789192
"17:43830534:<DEL>:308:323.73:Lumpy:SVtyper:0.004","<DEL>","17",43830534,308,NA,0,"Human",0.008510638,43830842
"12:54853498:<DEL>:311:1908.77:Lumpy:SVtyper:0.072","<DEL>","12",54853498,311,NA,0,"Human",0.140425532,54853809
"22:39607659:<DEL>:320:610.54:Lumpy:SVtyper:0.080","<DEL>","22",39607659,320,"intergenic",0,"Human",0.165957447,39607979
"4:86310520:<DEL>:311:867.53:Lumpy:SVtyper:0.453","<DEL>","4",86310520,311,"intergenic",0,"Human",0.608510638,86310831
"3:189955410:<DEL>:301:674.17:Lumpy:SVtyper:0.188","<DEL>","3",189955410,301,"intergenic",0,"Human",0.344680851,189955711
"9:128940624:<DEL>:299:1150.965:Lumpy:Both:0.011","<DEL>","9",128940624,299,"intergenic",0,"Human",0.021276596,128940923
"2:119046646:<DEL>:290:505.09:Lumpy:SVtyper:0.025","<DEL>","2",119046646,290,"intergenic",0,"Human",0.063829787,119046936
"6:20765368:<DEL>:320:2090.30:Lumpy:SVtyper:0.460","<DEL>","6",20765368,320,NA,0,"Human",0.642553191,20765688
"2:182355981:<DEL>:315:785.425:Lumpy:SVtyper:0.819","<DEL>","2",182355981,315,NA,0,"Human",0.85106383,182356296
"1:229284897:<DUP>:307:190.63:Lumpy:SVtyper:0.188","<DUP>","1",229284897,307,"intergenic",0,"Human",0.357446809,229285204
"16:530757:<DEL>:312:750.78:Lumpy:SVtyper:0.007","<DEL>","16",530757,312,NA,0,"Human",0.012765957,531069
"19:23320789:<DEL>:317:770.85:Lumpy:SVtyper:0.594","<DEL>","19",23320789,317,NA,0,"Human",0.740425532,23321106
"5:8027012:<DEL>:323:732.165:Lumpy:SVtyper:0.130","<DEL>","5",8027012,323,"intergenic",0,"Human",0.208510638,8027335
"11:106595871:<DEL>:297:2115.375:Lumpy:SVtyper:0.319","<DEL>","11",106595871,297,NA,0,"Human",0.523404255,106596168
"6:32313777:<DEL>:323:412.32:Lumpy:SVtyper:0.007","<DEL>","6",32313777,323,NA,0,"Human",0.012765957,32314100
"8:82640499:<DEL>:300:419.87:Lumpy:SVtyper:0.014","<DEL>","8",82640499,300,"intergenic",0,"Human",0.025531915,82640799
"14:42486330:<DEL>:315:1621.28:Lumpy:SVtyper:0.591","<DEL>","14",42486330,315,"intergenic",0,"Human",0.774468085,42486645
"4:184303689:<DEL>:323:1289.06:Lumpy:SVtyper:0.775","<DEL>","4",184303689,323,"intergenic",0,"Human",0.808510638,184304012
"13:69966665:<DEL>:299:2142.84:Lumpy:SVtyper:0.739","<DEL>","13",69966665,299,"intergenic",0,"Human",0.834042553,69966964
"6:95335623:<DEL>:305:445.24:Lumpy:SVtyper:0.620","<DEL>","6",95335623,305,"intergenic",0,"Human",0.774468085,95335928
"8:41930251:<DEL>:315:358.11:Lumpy:SVtyper:0.004","<DEL>","8",41930251,315,"intergenic",0,"Human",0.004255319,41930566
"9:77897715:<DEL>:317:728.11:Lumpy:SVtyper:0.014","<DEL>","9",77897715,317,"intergenic",0,"Human",0.038297872,77898032
"4:190291419:<DEL>:319:1904.645:Lumpy:SVtyper:0.623","<DEL>","4",190291419,319,"intergenic",0,"Human",0.770212766,190291738
"2:141707245:<DEL>:296:170.15:Lumpy:SVtyper:0.004","<DEL>","2",141707245,296,NA,0,"Human",0.004255319,141707541
"20:7274345:<DEL>:313:1530.12:Lumpy:SVtyper:0.703","<DEL>","20",7274345,313,"intergenic",0,"Human",0.8,7274658
"1:184937049:<DEL>:322:278.02:Lumpy:SVtyper:0.011","<DEL>","1",184937049,322,NA,0,"Human",0.017021277,184937371
"7:117893955:<DEL>:302:1218.245:Lumpy:SVtyper:0.380","<DEL>","7",117893955,302,"intergenic",0,"Human",0.595744681,117894257
"6:136235622:<DEL>:310:326.57:Both:Both:0.228","<DEL>","6",136235622,310,NA,0,"Human",0.4,136235932
"4:164501950:<DEL>:313:1065.08:Lumpy:SVtyper:0.004","<DEL>","4",164501950,313,NA,0,"Human",0.004255319,164502263
"7:56314081:<DEL>:319:451.43:Lumpy:SVtyper:0.069","<DEL>","7",56314081,319,"intergenic",0,"Human",0.131914894,56314400
"4:66755388:<DEL>:281:408.815:Lumpy:SVtyper:0.268","<DEL>","4",66755388,281,"intergenic",0,"Human",0.463829787,66755669
"13:29891563:<DEL>:311:728.65:Lumpy:SVtyper:0.065","<DEL>","13",29891563,311,NA,0,"Human",0.09787234,29891874
"7:127620156:<DEL>:318:704.12:Lumpy:SVtyper:0.007","<DEL>","7",127620156,318,NA,0,"Human",0.012765957,127620474
"11:33537680:<DEL>:324:1620.91:Lumpy:SVtyper:0.543","<DEL>","11",33537680,324,"intergenic",0,"Human",0.723404255,33538004
"15:66633819:<DEL>:321:1265.445:Lumpy:SVtyper:0.217","<DEL>","15",66633819,321,NA,0,"Human",0.429787234,66634140
"11:12943734:<DEL>:277:991.32:Lumpy:SVtyper:0.301","<DEL>","11",12943734,277,NA,0,"Human",0.49787234,12944011
"5:62620689:<DEL>:322:1147.73:Lumpy:SVtyper:0.072","<DEL>","5",62620689,322,"intergenic",0,"Human",0.127659574,62621011
"7:101334199:<DEL>:320:1125.625:Lumpy:SVtyper:0.475","<DEL>","7",101334199,320,"intergenic",0,"Human",0.782978723,101334519
"22:48645214:<DEL>:318:1689.49:Lumpy:SVtyper:0.612","<DEL>","22",48645214,318,"intergenic",0,"Human",0.761702128,48645532
"21:37644964:<DEL>:318:779.09:Lumpy:Both:0.004","<DEL>","21",37644964,318,NA,0,"Human",0.008510638,37645282
"3:28773914:<DEL>:312:253.47:Lumpy:SVtyper:0.004","<DEL>","3",28773914,312,"intergenic",0,"Human",0.008510638,28774226
"19:2299444:<DEL>:300:300.54:Lumpy:SVtyper:0.004","<DEL>","19",2299444,300,NA,0,"Human",0.008510638,2299744
"5:41603993:<DEL>:322:701.95:Lumpy:SVtyper:0.116","<DEL>","5",41603993,322,"intergenic",0,"Human",0.208510638,41604315
"7:70567076:<DEL>:325:502.40:Lumpy:SVtyper:0.058","<DEL>","7",70567076,325,"intergenic",0,"Human",0.10212766,70567401
"6:123763422:<DEL>:305:528.29:Lumpy:SVtyper:0.004","<DEL>","6",123763422,305,NA,0,"Human",0.004255319,123763727
"1:2911539:<DEL>:314:605.95:Lumpy:SVtyper:0.112","<DEL>","1",2911539,314,"intergenic",0,"Human",0.187234043,2911853
"7:5588442:<DEL>:290:250.52:Lumpy:SVtyper:0.007","<DEL>","7",5588442,290,"intergenic",0,"Human",0.008510638,5588732
"X:146849496:<DEL>:316:1084.05:Lumpy:SVtyper:0.005","<DEL>","X",146849496,316,"intergenic",0,"Human",0.004255319,146849812
"11:48695868:<DEL>:320:324.955:Lumpy:Both:0.004","<DEL>","11",48695868,320,"intergenic",0,"Human",0.004255319,48696188
"21:42457884:<DEL>:285:470.845:Lumpy:SVtyper:0.007","<DEL>","21",42457884,285,"intergenic",0,"Human",0.012765957,42458169
"7:44266952:<DEL>:318:145.765:Lumpy:SVtyper:0.040","<DEL>","7",44266952,318,NA,0,"Human",0.080851064,44267270
"21:46906116:<DEL>:307:549.32:Lumpy:SVtyper:0.007","<DEL>","21",46906116,307,NA,0,"Human",0.008510638,46906423
"5:79013705:<DEL>:307:797.69:Lumpy:SVtyper:0.322","<DEL>","5",79013705,307,NA,0,"Human",0.536170213,79014012
"4:89522916:<DEL>:315:678.36:Lumpy:SVtyper:0.083","<DEL>","4",89522916,315,NA,0,"Human",0.165957447,89523231
"1:73753601:<DEL>:315:211.94:Lumpy:SVtyper:0.007","<DEL>","1",73753601,315,"intergenic",0,"Human",0.012765957,73753916
"17:19410153:<DEL>:296:582.22:Lumpy:SVtyper:0.181","<DEL>","17",19410153,296,"intergenic",0,"Human",0.323404255,19410449
"6:106983632:<DEL>:319:2039.96:Lumpy:SVtyper:0.768","<DEL>","6",106983632,319,NA,0,"Human",0.880851064,106983951
"5:99923539:<DEL>:305:464.765:Lumpy:SVtyper:0.029","<DEL>","5",99923539,305,NA,0,"Human",0.046808511,99923844
"14:81469123:<DEL>:312:790.14:Lumpy:SVtyper:0.355","<DEL>","14",81469123,312,NA,0,"Human",0.540425532,81469435
"2:130037099:<DEL>:309:831.26:Lumpy:SVtyper:0.047","<DEL>","2",130037099,309,"intergenic",0,"Human",0.080851064,130037408
"2:50708889:<DEL>:320:991.05:Lumpy:SVtyper:0.004","<DEL>","2",50708889,320,NA,0,"Human",0.008510638,50709209
"4:190302414:<DEL>:311:1073.72:Lumpy:SVtyper:0.014","<DEL>","4",190302414,311,"intergenic",0,"Human",0.012765957,190302725
"5:119015150:<DEL>:320:515.745:Lumpy:SVtyper:0.007","<DEL>","5",119015150,320,"intergenic",0,"Human",0.012765957,119015470
"5:28356945:<DEL>:288:148.85:Lumpy:SVtyper:0.257","<DEL>","5",28356945,288,"intergenic",0,"Human",0.421276596,28357233
"4:130590926:<DEL>:291:309.84:Lumpy:SVtyper:0.004","<DEL>","4",130590926,291,"intergenic",0,"Human",0.017021277,130591217
"18:32661963:<DEL>:317:1025.03:Lumpy:SVtyper:0.207","<DEL>","18",32661963,317,NA,0,"Human",0.357446809,32662280
"18:73303017:<DEL>:318:463.83:Lumpy:SVtyper:0.025","<DEL>","18",73303017,318,"intergenic",0,"Human",0.05106383,73303335
"8:69417682:<DEL>:322:898.82:Lumpy:SVtyper:0.112","<DEL>","8",69417682,322,NA,0,"Human",0.2,69418004
"10:122701140:<DEL>:292:707.485:Lumpy:SVtyper:0.399","<DEL>","10",122701140,292,"intergenic",0,"Human",0.617021277,122701432
"7:117893955:<DEL>:302:864.03:Lumpy:SVtyper:0.004","<DEL>","7",117893955,302,"intergenic",0,"Human",0.008510638,117894257
"19:1247092:<DEL>:282:329.54:Lumpy:SVtyper:0.054","<DEL>","19",1247092,282,"intergenic",0,"Human",0.119148936,1247374
"8:16545425:<DEL>:325:663.12:Lumpy:SVtyper:0.029","<DEL>","8",16545425,325,"intergenic",0,"Human",0.055319149,16545750
"22:33295767:<DEL>:318:1389.71:Lumpy:SVtyper:0.721","<DEL>","22",33295767,318,NA,0,"Human",0.829787234,33296085
"10:85783446:<DEL>:309:489.17:Lumpy:SVtyper:0.004","<DEL>","10",85783446,309,"intergenic",0,"Human",0.004255319,85783755
"1:157916597:<DEL>:317:1303.61:Lumpy:SVtyper:0.004","<DEL>","1",157916597,317,"intergenic",0,"Human",0.008510638,157916914
"15:32291224:<DEL>:308:964.61:Lumpy:SVtyper:0.105","<DEL>","15",32291224,308,"intergenic",0,"Human",0.157446809,32291532
"2:193355405:<DEL>:305:1601.37:Lumpy:SVtyper:0.732","<DEL>","2",193355405,305,"intergenic",0,"Human",0.731914894,193355710
"8:16962218:<DEL>:322:569.405:Lumpy:SVtyper:0.004","<DEL>","8",16962218,322,NA,0,"Human",0.017021277,16962540
"7:152419410:<DEL>:316:1031.095:Lumpy:SVtyper:0.558","<DEL>","7",152419410,316,"intergenic",0,"Human",0.723404255,152419726
"1:77111969:<DEL>:303:253.755:Lumpy:SVtyper:0.004","<DEL>","1",77111969,303,"intergenic",0,"Human",0.004255319,77112272
"6:159666771:<DEL>:323:139.67:Both:Both:0.004","<DEL>","6",159666771,323,NA,0,"Human",0.008510638,159667094
"16:49979401:<DEL>:314:1385.05:Lumpy:SVtyper:0.232","<DEL>","16",49979401,314,"intergenic",0,"Human",0.382978723,49979715
"10:15532465:<DEL>:310:481.62:Lumpy:SVtyper:0.004","<DEL>","10",15532465,310,"intergenic",0,"Human",0.008510638,15532775
"10:10493410:<DEL>:323:1207.86:Lumpy:SVtyper:0.554","<DEL>","10",10493410,323,"intergenic",0,"Human",0.727659574,10493733
"18:28071093:<DEL>:314:543.66:Lumpy:SVtyper:0.007","<DEL>","18",28071093,314,"intergenic",0,"Human",0.012765957,28071407
"1:58343213:<DEL>:324:850.41:Lumpy:SVtyper:0.496","<DEL>","1",58343213,324,NA,0,"Human",0.736170213,58343537
"9:6888774:<DEL>:314:330.07:Lumpy:SVtyper:0.014","<DEL>","9",6888774,314,NA,0,"Human",0.021276596,6889088
"20:61897950:<DEL>:309:200.085:Lumpy:SVtyper:0.018","<DEL>","20",61897950,309,"intergenic",0,"Human",0.038297872,61898259
"13:69966665:<DEL>:299:1671.825:Lumpy:SVtyper:0.011","<DEL>","13",69966665,299,"intergenic",0,"Human",0.012765957,69966964
"9:110432887:<DEL>:319:503.48:Lumpy:SVtyper:0.326","<DEL>","9",110432887,319,"intergenic",0,"Human",0.570212766,110433206
"X:43823272:<DEL>:289:728.68:Both:Both:0.005","<DEL>","X",43823272,289,NA,0,"Human",0.008510638,43823561
"11:102471850:<DEL>:316:868.205:Lumpy:SVtyper:0.007","<DEL>","11",102471850,316,NA,0,"Human",0.008510638,102472166
"3:190696653:<DEL>:296:412.05:Lumpy:SVtyper:0.004","<DEL>","3",190696653,296,"intergenic",0,"Human",0.008510638,190696949
"X:85537773:<DEL>:313:290.56:Lumpy:SVtyper:0.517","<DEL>","X",85537773,313,NA,0,"Human",0.595744681,85538086
"9:115937090:<DEL>:295:1424.96:Lumpy:SVtyper:0.011","<DEL>","9",115937090,295,NA,0,"Human",0.012765957,115937385
"4:1059518:<DEL>:287:738.36:Lumpy:SVtyper:0.022","<DEL>","4",1059518,287,"intergenic",0,"Human",0.038297872,1059805
"19:18661296:<DEL>:320:658.4:Lumpy:SVtyper:0.065","<DEL>","19",18661296,320,"intergenic",0,"Human",0.106382979,18661616
"8:41279337:<DEL>:323:537.18:Lumpy:SVtyper:0.634","<DEL>","8",41279337,323,"intergenic",0,"Human",0.727659574,41279660
"20:55287954:<DEL>:276:611.62:Lumpy:SVtyper:0.004","<DEL>","20",55287954,276,"intergenic",0,"Human",0.012765957,55288230
"8:42572233:<DEL>:321:661.37:Lumpy:SVtyper:0.040","<DEL>","8",42572233,321,NA,0,"Human",0.080851064,42572554
"8:6790872:<DEL>:322:403.685:Lumpy:SVtyper:0.007","<DEL>","8",6790872,322,"intergenic",0,"Human",0.012765957,6791194
"7:86829341:<DEL>:314:534.35:Lumpy:Both:0.004","<DEL>","7",86829341,314,NA,0,"Human",0.008510638,86829655
"4:141926929:<DEL>:313:1146.11:Lumpy:SVtyper:0.040","<DEL>","4",141926929,313,NA,0,"Human",0.076595745,141927242
"7:57364901:<DEL>:324:844.04:Lumpy:SVtyper:0.395","<DEL>","7",57364901,324,"intergenic",0,"Human",0.574468085,57365225
"19:56019998:<DEL>:294:481.08:Lumpy:SVtyper:0.094","<DEL>","19",56019998,294,NA,0,"Human",0.14893617,56020292
"4:186155546:<DEL>:311:2561.335:Lumpy:SVtyper:0.018","<DEL>","4",186155546,311,NA,0,"Human",0.017021277,186155857
"3:28483939:<DUP>:314:215.4:Lumpy:SVtyper:0.004","<DUP>","3",28483939,314,NA,0,"Human",0.008510638,28484253
"4:98181267:<DEL>:316:1225.68:Lumpy:SVtyper:0.065","<DEL>","4",98181267,316,"intergenic",0,"Human",0.114893617,98181583
"10:113191556:<DEL>:310:832.76:Lumpy:SVtyper:0.228","<DEL>","10",113191556,310,"intergenic",0,"Human",0.489361702,113191866
"X:143843283:<DEL>:307:863.22:Lumpy:SVtyper:0.014","<DEL>","X",143843283,307,"intergenic",0,"Human",0.012765957,143843590
"10:78800903:<DEL>:319:472.315:Lumpy:SVtyper:0.007","<DEL>","10",78800903,319,NA,0,"Human",0.012765957,78801222
"2:127338525:<DEL>:286:389.94:Both:Both:0.004","<DEL>","2",127338525,286,"intergenic",0,"Human",0.004255319,127338811
"2:240958949:<DEL>:322:2490.895:Lumpy:SVtyper:0.417","<DEL>","2",240958949,322,NA,0,"Human",0.65106383,240959271
"2:169395467:<DEL>:312:1981.435:Lumpy:SVtyper:0.007","<DEL>","2",169395467,312,NA,0,"Human",0.012765957,169395779
"6:38922200:<DEL>:315:353.53:Lumpy:SVtyper:0.007","<DEL>","6",38922200,315,NA,0,"Human",0.012765957,38922515
"5:89860423:<DEL>:321:1116.18:Lumpy:SVtyper:0.409","<DEL>","5",89860423,321,NA,0,"Human",0.617021277,89860744
"14:83019611:<DEL>:281:1523.40:Lumpy:SVtyper:0.011","<DEL>","14",83019611,281,"intergenic",0,"Human",0.012765957,83019892
"1:3591540:<DEL>:301:818.46:Lumpy:SVtyper:0.065","<DEL>","1",3591540,301,NA,0,"Human",0.09787234,3591841
"10:70998111:<DEL>:324:1438.44:Lumpy:SVtyper:0.007","<DEL>","10",70998111,324,NA,0,"Human",0.012765957,70998435
"2:196031315:<DEL>:305:1807.12:Lumpy:SVtyper:0.790","<DEL>","2",196031315,305,"intergenic",0,"Human",0.821276596,196031620
"9:30491284:<DEL>:311:2181.185:Lumpy:SVtyper:0.678","<DEL>","9",30491284,311,"intergenic",0,"Human",0.829787234,30491595
"11:25672969:<DEL>:277:430.665:Lumpy:SVtyper:0.004","<DEL>","11",25672969,277,"intergenic",0,"Human",0.008510638,25673246
"5:23413764:<DEL>:317:879.94:Lumpy:SVtyper:0.072","<DEL>","5",23413764,317,"intergenic",0,"Human",0.114893617,23414081
"2:16251108:<DEL>:325:413.405:Lumpy:SVtyper:0.011","<DEL>","2",16251108,325,"intergenic",0,"Human",0.017021277,16251433
"9:119531185:<DEL>:278:758.04:Lumpy:SVtyper:0.004","<DEL>","9",119531185,278,NA,0,"Human",0.004255319,119531463
"11:34108876:<DEL>:309:825.74:Lumpy:SVtyper:0.054","<DEL>","11",34108876,309,NA,0,"Human",0.114893617,34109185
"4:30127760:<DEL>:316:918.78:Lumpy:SVtyper:0.076","<DEL>","4",30127760,316,"intergenic",0,"Human",0.157446809,30128076
"1:20581433:<DEL>:323:258.07:Lumpy:SVtyper:0.007","<DEL>","1",20581433,323,"intergenic",0,"Human",0.012765957,20581756
"9:101209332:<DEL>:314:476.635:Lumpy:SVtyper:0.130","<DEL>","9",101209332,314,NA,0,"Human",0.255319149,101209646
"6:75957788:<DEL>:319:1266.93:Lumpy:SVtyper:0.743","<DEL>","6",75957788,319,"intergenic",0,"Human",0.808510638,75958107
"11:103410823:<DEL>:313:3149.065:Lumpy:SVtyper:0.011","<DEL>","11",103410823,313,"intergenic",0,"Human",0.012765957,103411136
"X:79072193:<DEL>:318:648.30:Lumpy:SVtyper:0.314","<DEL>","X",79072193,318,"intergenic",0,"Human",0.438297872,79072511
"10:118265319:<DEL>:323:999.955:Lumpy:SVtyper:0.533","<DEL>","10",118265319,323,"intergenic",0,"Human",0.770212766,118265642
"18:9385396:<DEL>:324:946.205:Lumpy:SVtyper:0.348","<DEL>","18",9385396,324,NA,0,"Human",0.574468085,9385720
"13:24710956:<DEL>:314:195.50:Lumpy:SVtyper:0.004","<DEL>","13",24710956,314,NA,0,"Human",0.004255319,24711270
"3:159518433:<DEL>:303:905.29:Both:Both:0.004","<DEL>","3",159518433,303,NA,0,"Human",0.008510638,159518736
"2:222388285:<DEL>:299:461.95:Lumpy:SVtyper:0.007","<DEL>","2",222388285,299,NA,0,"Human",0.017021277,222388584
"X:96194662:<DEL>:303:385.285:Lumpy:SVtyper:0.005","<DEL>","X",96194662,303,NA,0,"Human",0.008510638,96194965
"7:86836616:<DEL>:309:2206.81:Lumpy:SVtyper:0.696","<DEL>","7",86836616,309,NA,0,"Human",0.795744681,86836925
"9:89799096:<DEL>:314:1995.025:Lumpy:SVtyper:0.007","<DEL>","9",89799096,314,"intergenic",0,"Human",0.012765957,89799410
"5:171514607:<DEL>:325:1487.775:Lumpy:SVtyper:0.145","<DEL>","5",171514607,325,NA,0,"Human",0.246808511,171514932
"9:30345782:<DEL>:318:727.30:Lumpy:SVtyper:0.007","<DEL>","9",30345782,318,"intergenic",0,"Human",0.021276596,30346100
"19:40257526:<DEL>:325:677.13:Lumpy:SVtyper:0.047","<DEL>","19",40257526,325,"intergenic",0,"Human",0.076595745,40257851
"1:182289332:<DEL>:312:387.51:Lumpy:SVtyper:0.047","<DEL>","1",182289332,312,"intergenic",0,"Human",0.106382979,182289644
"13:51551940:<DEL>:323:832.35:Lumpy:SVtyper:0.254","<DEL>","13",51551940,323,"intergenic",0,"Human",0.442553191,51552263
"16:72565834:<DEL>:285:732.695:Lumpy:SVtyper:0.004","<DEL>","16",72565834,285,"intergenic",0,"Human",0.008510638,72566119
"16:49979401:<DEL>:314:244.05:Lumpy:SVtyper:0.004","<DEL>","16",49979401,314,"intergenic",0,"Human",0.004255319,49979715
"3:174416373:<DEL>:323:484.32:Lumpy:SVtyper:0.083","<DEL>","3",174416373,323,"intergenic",0,"Human",0.165957447,174416696
"2:136222643:<DEL>:315:334.65:Lumpy:SVtyper:0.004","<DEL>","2",136222643,315,NA,0,"Human",0.008510638,136222958
"6:132697631:<DEL>:323:577.77:Lumpy:SVtyper:0.225","<DEL>","6",132697631,323,NA,0,"Human",0.370212766,132697954
"4:22288112:<DEL>:304:657.855:Lumpy:SVtyper:0.004","<DEL>","4",22288112,304,"intergenic",0,"Human",0.008510638,22288416
"2:36955664:<DEL>:316:901.38:Lumpy:SVtyper:0.007","<DEL>","2",36955664,316,NA,0,"Human",0.017021277,36955980
"8:89392208:<DEL>:307:1633.435:Lumpy:SVtyper:0.011","<DEL>","8",89392208,307,"intergenic",0,"Human",0.012765957,89392515
"9:134391430:<DEL>:297:148.155:Lumpy:SVtyper:0.007","<DEL>","9",134391430,297,NA,0,"Human",0.008510638,134391727
"4:187795709:<DEL>:320:475.825:Lumpy:SVtyper:0.007","<DEL>","4",187795709,320,"intergenic",0,"Human",0.021276596,187796029
"6:12664199:<DEL>:322:954.10:Lumpy:SVtyper:0.004","<DEL>","6",12664199,322,"intergenic",0,"Human",0.008510638,12664521
"X:119643310:<DEL>:315:951.6:Lumpy:SVtyper:0.551","<DEL>","X",119643310,315,"intergenic",0,"Human",0.634042553,119643625
"7:39870035:<DEL>:310:492.14:Lumpy:SVtyper:0.105","<DEL>","7",39870035,310,"intergenic",0,"Human",0.187234043,39870345
"12:105773516:<DEL>:324:1004.54:Lumpy:SVtyper:0.366","<DEL>","12",105773516,324,"intergenic",0,"Human",0.604255319,105773840
"11:119719486:<DEL>:322:264.54:Lumpy:SVtyper:0.199","<DEL>","11",119719486,322,"intergenic",0,"Human",0.314893617,119719808
"2:173888923:<DEL>:324:1349.72:Lumpy:SVtyper:0.004","<DEL>","2",173888923,324,NA,0,"Human",0.004255319,173889247
"14:31943002:<DEL>:325:444.005:Lumpy:SVtyper:0.402","<DEL>","14",31943002,325,"intergenic",0,"Human",0.6,31943327
"13:64448586:<DEL>:314:536.235:Lumpy:SVtyper:0.004","<DEL>","13",64448586,314,"intergenic",0,"Human",0.008510638,64448900
"11:103410823:<DEL>:313:719.75:Lumpy:SVtyper:0.007","<DEL>","11",103410823,313,"intergenic",0,"Human",0.012765957,103411136
"2:110278188:<DEL>:304:459.925:Lumpy:SVtyper:0.004","<DEL>","2",110278188,304,"intergenic",0,"Human",0.008510638,110278492
"10:68241213:<DEL>:309:858.91:Lumpy:SVtyper:0.004","<DEL>","10",68241213,309,NA,0,"Human",0.004255319,68241522
"6:37294963:<DEL>:323:659.35:Lumpy:SVtyper:0.123","<DEL>","6",37294963,323,NA,0,"Human",0.221276596,37295286
"12:126905107:<DEL>:314:829.24:Lumpy:SVtyper:0.417","<DEL>","12",126905107,314,"intergenic",0,"Human",0.659574468,126905421
"X:22855549:<DEL>:289:553.63:Lumpy:SVtyper:0.005","<DEL>","X",22855549,289,"intergenic",0,"Human",0.008510638,22855838
"17:64583583:<DEL>:319:127.82:Lumpy:SVtyper:0","<DEL>","17",64583583,319,NA,0,"Human",0.004255319,64583902
"3:20919492:<DEL>:275:662.71:Lumpy:SVtyper:0.051","<DEL>","3",20919492,275,"intergenic",0,"Human",0.10212766,20919767
"5:13855308:<DEL>:315:1593.645:Lumpy:SVtyper:0.040","<DEL>","5",13855308,315,NA,0,"Human",0.072340426,13855623
"9:84898392:<DEL>:306:894.77:Lumpy:Both:0.007","<DEL>","9",84898392,306,"intergenic",0,"Human",0.012765957,84898698
"10:13258018:<DEL>:312:1065.48:Lumpy:SVtyper:0.322","<DEL>","10",13258018,312,"intergenic",0,"Human",0.506382979,13258330
"9:11433121:<DEL>:315:522.615:Lumpy:SVtyper:0.134","<DEL>","9",11433121,315,"intergenic",0,"Human",0.255319149,11433436
"20:30899231:<DEL>:305:1865.01:Lumpy:SVtyper:0.638","<DEL>","20",30899231,305,NA,0,"Human",0.782978723,30899536
"6:4050243:<DEL>:319:1260.585:Lumpy:SVtyper:0.739","<DEL>","6",4050243,319,NA,0,"Human",0.838297872,4050562
"3:17731688:<DEL>:325:556.06:Lumpy:SVtyper:0.420","<DEL>","3",17731688,325,NA,0,"Human",0.625531915,17732013
"1:40732992:<DEL>:321:431.065:Lumpy:SVtyper:0.014","<DEL>","1",40732992,321,NA,0,"Human",0.029787234,40733313
"7:138742278:<DEL>:317:724.875:Lumpy:SVtyper:0.007","<DEL>","7",138742278,317,NA,0,"Human",0.012765957,138742595
"18:55671122:<DEL>:307:2070.39:Lumpy:SVtyper:0.779","<DEL>","18",55671122,307,"intergenic",0,"Human",0.808510638,55671429
"15:23042329:<DEL>:279:872.93:Lumpy:SVtyper:0.007","<DEL>","15",23042329,279,NA,0,"Human",0.017021277,23042608
"2:214353525:<DEL>:288:825.47:Lumpy:SVtyper:0.014","<DEL>","2",214353525,288,NA,0,"Human",0.029787234,214353813
"5:170131208:<DEL>:314:399.64:Lumpy:SVtyper:0.004","<DEL>","5",170131208,314,NA,0,"Human",0.004255319,170131522
"4:186481755:<DEL>:298:404.1:Lumpy:SVtyper:0.011","<DEL>","4",186481755,298,"intergenic",0,"Human",0.029787234,186482053
"20:19061421:<DEL>:313:665.81:Lumpy:SVtyper:0.536","<DEL>","20",19061421,313,"intergenic",0,"Human",0.727659574,19061734
"15:91190333:<DUP>:311:186.39:Lumpy:SVtyper:0.014","<DUP>","15",91190333,311,"intergenic",0,"Human",0.029787234,91190644
"12:97372256:<DEL>:316:527.48:Lumpy:SVtyper:0.062","<DEL>","12",97372256,316,"intergenic",0,"Human",0.119148936,97372572
"11:31152435:<DEL>:316:2133.415:Lumpy:SVtyper:0.014","<DEL>","11",31152435,316,"intergenic",0,"Human",0.034042553,31152751
"9:6888774:<DEL>:314:165.02:Lumpy:SVtyper:0.007","<DEL>","9",6888774,314,NA,0,"Human",0.017021277,6889088
"5:1039606:<DEL>:290:244.85:Lumpy:SVtyper:0.004","<DEL>","5",1039606,290,NA,0,"Human",0.004255319,1039896
"10:15532465:<DEL>:310:325.22:Lumpy:SVtyper:0.007","<DEL>","10",15532465,310,"intergenic",0,"Human",0.017021277,15532775
"13:89073258:<DEL>:291:335.33:Lumpy:SVtyper:0.275","<DEL>","13",89073258,291,"intergenic",0,"Human",0.49787234,89073549
"6:9075290:<DEL>:321:996.3:Lumpy:SVtyper:0.007","<DEL>","6",9075290,321,"intergenic",0,"Human",0.008510638,9075611
"13:98694744:<DEL>:318:195.50:Lumpy:SVtyper:0.004","<DEL>","13",98694744,318,"intergenic",0,"Human",0.004255319,98695062
"12:82802096:<DEL>:282:1362.65:Lumpy:Both:0.004","<DEL>","12",82802096,282,NA,0,"Human",0.004255319,82802378
"5:1682468:<DEL>:312:801.735:Lumpy:SVtyper:0.152","<DEL>","5",1682468,312,"intergenic",0,"Human",0.242553191,1682780
"6:33475542:<DEL>:321:447.115:Lumpy:SVtyper:0.076","<DEL>","6",33475542,321,"intergenic",0,"Human",0.131914894,33475863
"4:186155546:<DEL>:311:790.275:Lumpy:SVtyper:0.486","<DEL>","4",186155546,311,NA,0,"Human",0.659574468,186155857
"10:10980847:<DEL>:316:475.695:Lumpy:SVtyper:0.007","<DEL>","10",10980847,316,"intergenic",0,"Human",0.008510638,10981163
"3:68890216:<DEL>:289:518.58:Lumpy:SVtyper:0.243","<DEL>","3",68890216,289,NA,0,"Human",0.404255319,68890505
"3:117517160:<DUP>:320:226.93:Lumpy:SVtyper:0.004","<DUP>","3",117517160,320,"intergenic",0,"Human",0.008510638,117517480
"17:5464743:<DEL>:324:655.57:Lumpy:SVtyper:0.004","<DEL>","17",5464743,324,NA,0,"Human",0.008510638,5465067
"9:81725762:<DEL>:321:112.715:Lumpy:SVtyper:0.004","<DEL>","9",81725762,321,"intergenic",0,"Human",0.008510638,81726083
"3:185017329:<DEL>:325:788.52:Lumpy:SVtyper:0.014","<DEL>","3",185017329,325,NA,0,"Human",0.025531915,185017654
"3:46223507:<DEL>:288:611.335:Lumpy:SVtyper:0.007","<DEL>","3",46223507,288,"intergenic",0,"Human",0.017021277,46223795
"1:9123741:<DEL>:320:211.41:Lumpy:SVtyper:0.014","<DEL>","1",9123741,320,NA,0,"Human",0.017021277,9124061
"4:158107239:<DEL>:321:278.56:Lumpy:SVtyper:0.007","<DEL>","4",158107239,321,"intergenic",0,"Human",0.012765957,158107560
"9:81725759:<DEL>:323:1535.53:Lumpy:SVtyper:0.536","<DEL>","9",81725759,323,"intergenic",0,"Human",0.714893617,81726082
"17:56016559:<DEL>:313:464.78:Lumpy:SVtyper:0.004","<DEL>","17",56016559,313,NA,0,"Human",0.012765957,56016872
"12:41468725:<DEL>:287:311.72:Lumpy:Both:0.004","<DEL>","12",41468725,287,"intergenic",0,"Human",0.004255319,41469012
"4:69959843:<DEL>:324:1245.08:Lumpy:SVtyper:0.449","<DEL>","4",69959843,324,"intergenic",0,"Human",0.689361702,69960167
"2:62457091:<DEL>:315:756.91:Lumpy:SVtyper:0.105","<DEL>","2",62457091,315,"intergenic",0,"Human",0.195744681,62457406
"20:54033320:<DEL>:299:510.345:Lumpy:SVtyper:0.004","<DEL>","20",54033320,299,"intergenic",0,"Human",0.008510638,54033619
"12:38974622:<DEL>:283:786.64:Lumpy:SVtyper:0.014","<DEL>","12",38974622,283,"intergenic",0,"Human",0.025531915,38974905
"1:182952023:<DEL>:285:1609.475:Lumpy:SVtyper:0.159","<DEL>","1",182952023,285,"intergenic",0,"Human",0.293617021,182952308
"1:244439123:<DEL>:310:147.77:Lumpy:SVtyper:0.268","<DEL>","1",244439123,310,"intergenic",0,"Human",0.472340426,244439433
"2:36090509:<DEL>:320:775.85:Lumpy:SVtyper:0.101","<DEL>","2",36090509,320,"intergenic",0,"Human",0.187234043,36090829
"1:171261229:<DEL>:322:582.615:Lumpy:SVtyper:0.004","<DEL>","1",171261229,322,"intergenic",0,"Human",0.008510638,171261551
"6:168059219:<DEL>:318:574.67:Lumpy:SVtyper:0.069","<DEL>","6",168059219,318,"intergenic",0,"Human",0.140425532,168059537
"14:94985908:<DUP>:279:286.195:Lumpy:SVtyper:0.014","<DUP>","14",94985908,279,"intergenic",0,"Human",0.029787234,94986187
"11:40576277:<DEL>:300:864.84:Lumpy:SVtyper:0.007","<DEL>","11",40576277,300,NA,0,"Human",0.012765957,40576577
"6:38922200:<DEL>:315:1609.10:Lumpy:SVtyper:0.750","<DEL>","6",38922200,315,NA,0,"Human",0.829787234,38922515
"13:89073258:<DEL>:291:1097.175:Lumpy:SVtyper:0.007","<DEL>","13",89073258,291,"intergenic",0,"Human",0.012765957,89073549
"19:42418601:<DEL>:320:310.12:Lumpy:SVtyper:0.022","<DEL>","19",42418601,320,"intergenic",0,"Human",0.042553191,42418921
"7:13109758:<DEL>:312:355.43:Lumpy:SVtyper:0.004","<DEL>","7",13109758,312,"intergenic",0,"Human",0.004255319,13110070
"5:28356945:<DEL>:288:205.47:Lumpy:SVtyper:0.069","<DEL>","5",28356945,288,"intergenic",0,"Human",0.093617021,28357233
"13:24710956:<DEL>:314:1806.38:Lumpy:SVtyper:0.377","<DEL>","13",24710956,314,NA,0,"Human",0.565957447,24711270
"20:35815613:<DEL>:312:2055.8:Lumpy:SVtyper:0.007","<DEL>","20",35815613,312,NA,0,"Human",0.012765957,35815925
"22:38883198:<DEL>:276:518.57:Lumpy:SVtyper:0.004","<DEL>","22",38883198,276,NA,0,"Human",0.004255319,38883474
"7:148818175:<DEL>:312:1458.95:Lumpy:SVtyper:0.540","<DEL>","7",148818175,312,NA,0,"Human",0.8,148818487
"3:163464170:<DEL>:306:1905.395:Lumpy:SVtyper:0.692","<DEL>","3",163464170,306,"intergenic",0,"Human",0.842553191,163464476
"9:30345782:<DEL>:318:782.19:Lumpy:SVtyper:0.199","<DEL>","9",30345782,318,"intergenic",0,"Human",0.370212766,30346100
"3:6966120:<DEL>:312:516.95:Lumpy:SVtyper:0.004","<DEL>","3",6966120,312,NA,0,"Human",0.012765957,6966432
"5:166150752:<DEL>:320:486.62:Lumpy:SVtyper:0.083","<DEL>","5",166150752,320,"intergenic",0,"Human",0.170212766,166151072
"10:85783446:<DEL>:309:384.28:Lumpy:SVtyper:0.025","<DEL>","10",85783446,309,"intergenic",0,"Human",0.068085106,85783755
"11:26942644:<DEL>:311:594.35:Lumpy:Both:0.004","<DEL>","11",26942644,311,"intergenic",0,"Human",0.004255319,26942955
"11:359774:<DEL>:319:295.27:Lumpy:SVtyper:0.004","<DEL>","11",359774,319,"intergenic",0,"Human",0.008510638,360093
"9:122531837:<DEL>:318:924.29:Lumpy:SVtyper:0.014","<DEL>","9",122531837,318,"intergenic",0,"Human",0.034042553,122532155
"6:17472269:<DEL>:317:407.335:Lumpy:SVtyper:0.228","<DEL>","6",17472269,317,NA,0,"Human",0.353191489,17472586
"1:28247800:<DEL>:309:654.62:Lumpy:SVtyper:0.011","<DEL>","1",28247800,309,"intergenic",0,"Human",0.012765957,28248109
"2:81753607:<DEL>:305:815.36:Lumpy:SVtyper:0.069","<DEL>","2",81753607,305,"intergenic",0,"Human",0.14893617,81753912
"9:109024127:<DEL>:311:708.015:Lumpy:SVtyper:0.543","<DEL>","9",109024127,311,"intergenic",0,"Human",0.744680851,109024438
"5:4578985:<DEL>:296:112.43:Lumpy:SVtyper:0.004","<DEL>","5",4578985,296,"intergenic",0,"Human",0.004255319,4579281
"10:383244:<DEL>:280:210.61:Lumpy:SVtyper:0.004","<DEL>","10",383244,280,NA,0,"Human",0.012765957,383524
"3:185017329:<DEL>:325:220.31:Lumpy:SVtyper:0.004","<DEL>","3",185017329,325,NA,0,"Human",0.008510638,185017654
"5:21651572:<DEL>:323:705.45:Lumpy:SVtyper:0.163","<DEL>","5",21651572,323,"intergenic",0,"Human",0.285106383,21651895
"3:81907498:<DEL>:320:1362.655:Lumpy:SVtyper:0.007","<DEL>","3",81907498,320,"intergenic",0,"Human",0.021276596,81907818
"14:46577930:<DEL>:320:364.86:Lumpy:SVtyper:0.757","<DEL>","14",46577930,320,"intergenic",0,"Human",0.838297872,46578250
"2:211329397:<DEL>:319:524.915:Lumpy:SVtyper:0.014","<DEL>","2",211329397,319,NA,0,"Human",0.021276596,211329716
"7:37998511:<DEL>:315:1747.75:Lumpy:SVtyper:0.710","<DEL>","7",37998511,315,"intergenic",0,"Human",0.863829787,37998826
"8:64144871:<DEL>:312:505.5:Lumpy:SVtyper:0.065","<DEL>","8",64144871,312,"intergenic",0,"Human",0.127659574,64145183
"6:134592210:<DEL>:282:652.065:Lumpy:SVtyper:0.072","<DEL>","6",134592210,282,NA,0,"Human",0.136170213,134592492
"8:118223531:<DEL>:280:1317.815:Lumpy:SVtyper:0.699","<DEL>","8",118223531,280,"intergenic",0,"Human",0.829787234,118223811
"3:139890470:<DEL>:282:454.66:Lumpy:SVtyper:0.004","<DEL>","3",139890470,282,NA,0,"Human",0.008510638,139890752
"1:43008204:<DEL>:323:711.93:Lumpy:SVtyper:0.145","<DEL>","1",43008204,323,NA,0,"Human",0.276595745,43008527
"2:56083531:<DEL>:317:1806.99:Lumpy:SVtyper:0.319","<DEL>","2",56083531,317,"intergenic",0,"Human",0.485106383,56083848
"17:19543431:<DEL>:309:2197.23:Lumpy:SVtyper:0.580","<DEL>","17",19543431,309,"intergenic",0,"Human",0.757446809,19543740
"13:102886508:<DEL>:299:191.195:Lumpy:SVtyper:0.058","<DEL>","13",102886508,299,NA,0,"Human",0.106382979,102886807
"21:41098765:<DEL>:288:408.14:Lumpy:SVtyper:0.004","<DEL>","21",41098765,288,"intergenic",0,"Human",0.008510638,41099053
"10:82737739:<DEL>:319:692.79:Lumpy:SVtyper:0.221","<DEL>","10",82737739,319,"intergenic",0,"Human",0.387234043,82738058
"8:109730171:<DEL>:325:872.66:Lumpy:SVtyper:0.178","<DEL>","8",109730171,325,"intergenic",0,"Human",0.280851064,109730496
"12:86523322:<DEL>:320:737.695:Lumpy:SVtyper:0.011","<DEL>","12",86523322,320,NA,0,"Human",0.012765957,86523642
"1:241149864:<DEL>:325:442.79:Lumpy:SVtyper:0.004","<DEL>","1",241149864,325,NA,0,"Human",0.008510638,241150189
"19:56495761:<DEL>:317:438.75:Both:Both:0.029","<DEL>","19",56495761,317,NA,0,"Human",0.05106383,56496078
"2:150626971:<DEL>:321:321.71:Lumpy:SVtyper:0.351","<DEL>","2",150626971,321,"intergenic",0,"Human",0.578723404,150627292
"7:96067515:<DEL>:315:1489.72:Lumpy:SVtyper:0.630","<DEL>","7",96067515,315,"intergenic",0,"Human",0.757446809,96067830
"1:243655724:<DEL>:306:278.03:Lumpy:SVtyper:0.007","<DEL>","1",243655724,306,NA,0,"Human",0.017021277,243656030
"13:84479033:<DEL>:319:625.91:Lumpy:SVtyper:0.004","<DEL>","13",84479033,319,"intergenic",0,"Human",0.008510638,84479352
"7:137455272:<DEL>:307:1474.16:Lumpy:SVtyper:0.221","<DEL>","7",137455272,307,NA,0,"Human",0.361702128,137455579
"3:33722588:<DUP>:300:252.70:Lumpy:SVtyper:0.072","<DUP>","3",33722588,300,NA,0,"Human",0.153191489,33722888
"2:214775207:<DEL>:307:1085.97:Lumpy:SVtyper:0.493","<DEL>","2",214775207,307,NA,0,"Human",0.740425532,214775514
"4:98133378:<DEL>:314:524.24:Lumpy:SVtyper:0.275","<DEL>","4",98133378,314,"intergenic",0,"Human",0.442553191,98133692
"8:119447048:<DEL>:311:1738.91:Lumpy:SVtyper:0.609","<DEL>","8",119447048,311,NA,0,"Human",0.774468085,119447359
"1:55287552:<DEL>:318:1001.3:Lumpy:SVtyper:0.174","<DEL>","1",55287552,318,NA,0,"Human",0.327659574,55287870
"5:103062306:<DEL>:320:865.38:Lumpy:SVtyper:0.417","<DEL>","5",103062306,320,"intergenic",0,"Human",0.617021277,103062626
"4:23721677:<DEL>:321:1163.785:Lumpy:SVtyper:0.004","<DEL>","4",23721677,321,"intergenic",0,"Human",0.008510638,23721998
"4:62028312:<DEL>:283:836.80:Lumpy:SVtyper:0.261","<DEL>","4",62028312,283,"intergenic",0,"Human",0.434042553,62028595
"4:185665772:<DEL>:318:335.87:Lumpy:SVtyper:0.014","<DEL>","4",185665772,318,"intergenic",0,"Human",0.025531915,185666090
"5:9411771:<DEL>:314:1049.575:Lumpy:SVtyper:0.833","<DEL>","5",9411771,314,NA,0,"Human",0.859574468,9412085
"6:106983632:<DEL>:319:501.04:Both:Both:0.007","<DEL>","6",106983632,319,NA,0,"Human",0.012765957,106983951
"10:15471077:<DEL>:320:343.275:Lumpy:SVtyper:0.040","<DEL>","10",15471077,320,"intergenic",0,"Human",0.072340426,15471397
"9:21918067:<DEL>:305:1169.85:Lumpy:SVtyper:0.043","<DEL>","9",21918067,305,"intergenic",0,"Human",0.080851064,21918372
"1:46802679:<DEL>:290:312.14:Lumpy:SVtyper:0.004","<DEL>","1",46802679,290,"intergenic",0,"Human",0.008510638,46802969
"11:78170236:<DEL>:319:572.92:Lumpy:SVtyper:0.004","<DEL>","11",78170236,319,NA,0,"Human",0.008510638,78170555
"4:111808762:<DEL>:309:2714.18:Lumpy:SVtyper:0.826","<DEL>","4",111808762,309,"intergenic",0,"Human",0.821276596,111809071
"17:81024551:<DEL>:323:406.11:Lumpy:SVtyper:0.040","<DEL>","17",81024551,323,"intergenic",0,"Human",0.072340426,81024874
"1:61069718:<DEL>:311:220.58:Lumpy:SVtyper:0.007","<DEL>","1",61069718,311,"intergenic",0,"Human",0.017021277,61070029
"12:24442379:<DEL>:314:1599.71:Lumpy:SVtyper:0.033","<DEL>","12",24442379,314,NA,0,"Human",0.059574468,24442693
"X:45587564:<DEL>:307:721.59:Both:Both:0.565","<DEL>","X",45587564,307,"intergenic",0,"Human",0.642553191,45587871
"9:77319260:<DEL>:291:327.65:Lumpy:SVtyper:0.188","<DEL>","9",77319260,291,"intergenic",0,"Human",0.272340426,77319551
"8:30392282:<DEL>:304:181.75:Lumpy:SVtyper:0.007","<DEL>","8",30392282,304,NA,0,"Human",0.008510638,30392586
"3:8720798:<DEL>:276:411.655:Lumpy:SVtyper:0.004","<DEL>","3",8720798,276,"intergenic",0,"Human",0.008510638,8721074
"14:73953713:<DEL>:299:410.705:Lumpy:SVtyper:0.014","<DEL>","14",73953713,299,NA,0,"Human",0.025531915,73954012
"3:148566797:<DEL>:318:1255.87:Lumpy:SVtyper:0.808","<DEL>","3",148566797,318,NA,0,"Human",0.863829787,148567115
"8:478392:<DEL>:277:540.68:Lumpy:SVtyper:0.004","<DEL>","8",478392,277,NA,0,"Human",0.004255319,478669
"4:91382201:<DEL>:319:613.24:Lumpy:SVtyper:0.018","<DEL>","4",91382201,319,NA,0,"Human",0.025531915,91382520
"6:28750599:<DEL>:316:457.36:Lumpy:SVtyper:0.007","<DEL>","6",28750599,316,"intergenic",0,"Human",0.034042553,28750915
"4:178514250:<DEL>:319:976.22:Lumpy:SVtyper:0.572","<DEL>","4",178514250,319,"intergenic",0,"Human",0.774468085,178514569
"7:49552067:<DEL>:318:1058.46:Lumpy:SVtyper:0.330","<DEL>","7",49552067,318,"intergenic",0,"Human",0.536170213,49552385
"2:21572781:<DEL>:305:373.76:Lumpy:SVtyper:0.033","<DEL>","2",21572781,305,"intergenic",0,"Human",0.055319149,21573086
"3:68870466:<DEL>:298:1603.195:Lumpy:SVtyper:0.475","<DEL>","3",68870466,298,NA,0,"Human",0.693617021,68870764
"6:23300366:<DEL>:322:2941.135:Lumpy:SVtyper:0.743","<DEL>","6",23300366,322,"intergenic",0,"Human",0.834042553,23300688
"22:18054626:<DEL>:301:393.99:Lumpy:SVtyper:0.004","<DEL>","22",18054626,301,NA,0,"Human",0.008510638,18054927
"18:71273403:<DEL>:321:1105.93:Lumpy:SVtyper:0.018","<DEL>","18",71273403,321,"intergenic",0,"Human",0.034042553,71273724
"1:230531169:<DEL>:308:230.165:Lumpy:SVtyper:0.007","<DEL>","1",230531169,308,NA,0,"Human",0.021276596,230531477
"19:36662682:<DEL>:297:416.775:Lumpy:SVtyper:0.500","<DEL>","19",36662682,297,"intergenic",0,"Human",0.689361702,36662979
"8:128722349:<DEL>:295:312.805:Lumpy:SVtyper:0.004","<DEL>","8",128722349,295,"intergenic",0,"Human",0.008510638,128722644
"2:215583462:<DEL>:317:334.92:Lumpy:SVtyper:0.007","<DEL>","2",215583462,317,"intergenic",0,"Human",0.021276596,215583779
"17:74987522:<DEL>:319:1914.6:Lumpy:SVtyper:0.707","<DEL>","17",74987522,319,"intergenic",0,"Human",0.8,74987841
"15:80296901:<DEL>:290:111.62:Lumpy:SVtyper:0.047","<DEL>","15",80296901,290,"intergenic",0,"Human",0.080851064,80297191
"8:1130875:<DEL>:319:1421.76:Lumpy:SVtyper:0.087","<DEL>","8",1130875,319,"intergenic",0,"Human",0.161702128,1131194
"4:170808438:<DEL>:280:185.52:Lumpy:SVtyper:0.004","<DEL>","4",170808438,280,"intergenic",0,"Human",0.008510638,170808718
"15:79891856:<DEL>:321:492.825:Lumpy:SVtyper:0.011","<DEL>","15",79891856,321,"intergenic",0,"Human",0.025531915,79892177
"18:75261205:<DUP>:306:123.81:Lumpy:SVtyper:0.011","<DUP>","18",75261205,306,"intergenic",0,"Human",0.017021277,75261511
"16:23910887:<DEL>:306:2246.27:Both:Both:0.681","<DEL>","16",23910887,306,NA,0,"Human",0.910638298,23911193
"9:30491284:<DEL>:311:750.63:Lumpy:SVtyper:0.011","<DEL>","9",30491284,311,"intergenic",0,"Human",0.021276596,30491595
"18:24791589:<DEL>:284:793.92:Lumpy:SVtyper:0.170","<DEL>","18",24791589,284,"intergenic",0,"Human",0.30212766,24791873
"2:38851422:<DEL>:309:1362.13:Lumpy:SVtyper:0.022","<DEL>","2",38851422,309,"intergenic",0,"Human",0.038297872,38851731
"4:55482427:<DEL>:321:693.455:Lumpy:SVtyper:0.319","<DEL>","4",55482427,321,"intergenic",0,"Human",0.50212766,55482748
"8:4941227:<DEL>:297:993.88:Lumpy:SVtyper:0.011","<DEL>","8",4941227,297,"intergenic",0,"Human",0.017021277,4941524
"1:73753601:<DEL>:315:2650.55:Both:Both:0.011","<DEL>","1",73753601,315,"intergenic",0,"Human",0.012765957,73753916
"6:43705844:<DUP>:292:191.84:Lumpy:SVtyper:0.134","<DUP>","6",43705844,292,"intergenic",0,"Human",0.268085106,43706136
"7:7542318:<DEL>:300:931.585:Lumpy:SVtyper:0.326","<DEL>","7",7542318,300,NA,0,"Human",0.536170213,7542618
"6:116750825:<DEL>:319:223.00:Lumpy:SVtyper:0.014","<DEL>","6",116750825,319,NA,0,"Human",0.029787234,116751144
"1:224392825:<DEL>:313:1571.87:Lumpy:SVtyper:0.804","<DEL>","1",224392825,313,"intergenic",0,"Human",0.808510638,224393138
"12:113683111:<DEL>:320:1066.97:Lumpy:SVtyper:0.058","<DEL>","12",113683111,320,NA,0,"Human",0.114893617,113683431
"2:223481697:<DEL>:289:1102.29:Lumpy:SVtyper:0.011","<DEL>","2",223481697,289,NA,0,"Human",0.012765957,223481986
"12:66207064:<DEL>:292:652.195:Lumpy:SVtyper:0.004","<DEL>","12",66207064,292,"intergenic",0,"Human",0.008510638,66207356
"4:67537935:<DEL>:314:438.62:Lumpy:SVtyper:0.138","<DEL>","4",67537935,314,"intergenic",0,"Human",0.234042553,67538249
"12:83959223:<DEL>:316:603.51:Lumpy:SVtyper:0.413","<DEL>","12",83959223,316,"intergenic",0,"Human",0.634042553,83959539
"6:41953355:<DEL>:315:2185.975:Lumpy:SVtyper:0.011","<DEL>","6",41953355,315,NA,0,"Human",0.012765957,41953670
"9:14264632:<DEL>:286:823.84:Lumpy:Both:0.007","<DEL>","9",14264632,286,NA,0,"Human",0.012765957,14264918
"7:116842013:<DEL>:312:748.615:Lumpy:SVtyper:0.500","<DEL>","7",116842013,312,NA,0,"Human",0.625531915,116842325
"17:13704553:<DEL>:289:118.64:Lumpy:SVtyper:0.489","<DEL>","17",13704553,289,"intergenic",0,"Human",0.706382979,13704842
"6:32313777:<DEL>:323:1747.935:Lumpy:SVtyper:0.580","<DEL>","6",32313777,323,NA,0,"Human",0.723404255,32314100
"14:38643499:<DEL>:314:1347.97:Lumpy:SVtyper:0.159","<DEL>","14",38643499,314,"intergenic",0,"Human",0.29787234,38643813
"12:77908657:<DEL>:323:262.37:Lumpy:SVtyper:0.004","<DEL>","12",77908657,323,"intergenic",0,"Human",0.004255319,77908980
"4:32540601:<DEL>:315:708.7:Lumpy:SVtyper:0.163","<DEL>","4",32540601,315,"intergenic",0,"Human",0.276595745,32540916
"11:74532408:<DEL>:316:669.195:Lumpy:SVtyper:0.236","<DEL>","11",74532408,316,NA,0,"Human",0.370212766,74532724
"2:151903087:<DEL>:276:1971.93:Lumpy:SVtyper:0.761","<DEL>","2",151903087,276,"intergenic",0,"Human",0.791489362,151903363
"5:168394435:<DEL>:313:692.78:Lumpy:SVtyper:0.058","<DEL>","5",168394435,313,NA,0,"Human",0.114893617,168394748
"14:71320964:<DEL>:293:686.86:Lumpy:SVtyper:0.598","<DEL>","14",71320964,293,"intergenic",0,"Human",0.795744681,71321257
"4:15131557:<DEL>:306:513.99:Lumpy:SVtyper:0.004","<DEL>","4",15131557,306,"intergenic",0,"Human",0.008510638,15131863
"4:147920592:<DEL>:313:668.25:Lumpy:SVtyper:0.134","<DEL>","4",147920592,313,"intergenic",0,"Human",0.234042553,147920905
"8:4941227:<DEL>:297:538.00:Lumpy:SVtyper:0.007","<DEL>","8",4941227,297,"intergenic",0,"Human",0.012765957,4941524
"6:32749232:<DEL>:311:678.49:Lumpy:SVtyper:0.007","<DEL>","6",32749232,311,"intergenic",0,"Human",0.012765957,32749543
"6:133667829:<DEL>:295:898.41:Lumpy:SVtyper:0.007","<DEL>","6",133667829,295,NA,0,"Human",0.012765957,133668124
"19:57111547:<DEL>:318:1120.91:Lumpy:SVtyper:0.004","<DEL>","19",57111547,318,NA,0,"Human",0.008510638,57111865
"12:94358337:<DEL>:312:555.25:Lumpy:SVtyper:0.413","<DEL>","12",94358337,312,"intergenic",0,"Human",0.629787234,94358649
"5:104590947:<DEL>:322:926.33:Lumpy:SVtyper:0.022","<DEL>","5",104590947,322,"intergenic",0,"Human",0.025531915,104591269
"2:182592454:<DEL>:313:1365.63:Lumpy:SVtyper:0.025","<DEL>","2",182592454,313,"intergenic",0,"Human",0.042553191,182592767
"X:93742971:<DEL>:302:1194.65:Lumpy:Both:0.005","<DEL>","X",93742971,302,"intergenic",0,"Human",0.004255319,93743273
"11:37962063:<DEL>:325:866.455:Lumpy:SVtyper:0.163","<DEL>","11",37962063,325,"intergenic",0,"Human",0.289361702,37962388
"4:120017242:<DEL>:321:2383.44:Lumpy:SVtyper:0.801","<DEL>","4",120017242,321,"intergenic",0,"Human",0.855319149,120017563
"3:194614724:<DEL>:316:256.18:Lumpy:SVtyper:0.007","<DEL>","3",194614724,316,"intergenic",0,"Human",0.012765957,194615040
"4:187795709:<DEL>:320:1837.335:Lumpy:SVtyper:0.779","<DEL>","4",187795709,320,"intergenic",0,"Human",0.838297872,187796029
"9:15394879:<DEL>:317:1494.07:Lumpy:SVtyper:0.554","<DEL>","9",15394879,317,"intergenic",0,"Human",0.778723404,15395196
"5:53176934:<DEL>:305:1770.69:Lumpy:SVtyper:0.786","<DEL>","5",53176934,305,"intergenic",0,"Human",0.842553191,53177239
"2:156268285:<DEL>:297:140.49:Lumpy:SVtyper:0.007","<DEL>","2",156268285,297,"intergenic",0,"Human",0.012765957,156268582
"22:44935548:<DUP>:284:209.99:Lumpy:SVtyper:0.004","<DUP>","22",44935548,284,"intergenic",0,"Human",0.004255319,44935832
"7:29476921:<DEL>:310:450.07:Lumpy:SVtyper:0.167","<DEL>","7",29476921,310,NA,0,"Human",0.331914894,29477231
"6:85046164:<DEL>:321:583.57:Lumpy:SVtyper:0.004","<DEL>","6",85046164,321,"intergenic",0,"Human",0.008510638,85046485
"4:64098149:<DEL>:321:784.205:Lumpy:SVtyper:0.257","<DEL>","4",64098149,321,"intergenic",0,"Human",0.493617021,64098470
"3:17948544:<DEL>:320:898.55:Lumpy:SVtyper:0.051","<DEL>","3",17948544,320,"intergenic",0,"Human",0.110638298,17948864
"1:80114173:<DEL>:317:2018.75:Lumpy:SVtyper:0.304","<DEL>","1",80114173,317,"intergenic",0,"Human",0.489361702,80114490
"1:180183830:<DEL>:282:1756.60:Lumpy:SVtyper:0.764","<DEL>","1",180183830,282,"intergenic",0,"Human",0.770212766,180184112
"5:23374541:<DEL>:314:527.74:Lumpy:SVtyper:0.076","<DEL>","5",23374541,314,"intergenic",0,"Human",0.123404255,23374855
"15:98598703:<DEL>:314:130.52:Lumpy:SVtyper:0.395","<DEL>","15",98598703,314,"intergenic",0,"Human",0.582978723,98599017
"5:124717350:<DEL>:322:952.895:Lumpy:SVtyper:0.399","<DEL>","5",124717350,322,"intergenic",0,"Human",0.6,124717672
"9:136060716:<DEL>:317:1210.125:Lumpy:SVtyper:0.630","<DEL>","9",136060716,317,"intergenic",0,"Human",0.778723404,136061033
"7:105307849:<DEL>:316:619.17:Lumpy:SVtyper:0.181","<DEL>","7",105307849,316,NA,0,"Human",0.327659574,105308165
"7:138742278:<DEL>:317:868.07:Lumpy:SVtyper:0.011","<DEL>","7",138742278,317,NA,0,"Human",0.025531915,138742595
"5:130489771:<DEL>:313:688.745:Lumpy:SVtyper:0.022","<DEL>","5",130489771,313,"intergenic",0,"Human",0.046808511,130490084
"1:46207287:<DEL>:312:538.52:Lumpy:SVtyper:0.261","<DEL>","1",46207287,312,NA,0,"Human",0.421276596,46207599
"20:7274345:<DEL>:313:1452.48:Lumpy:SVtyper:0.018","<DEL>","20",7274345,313,"intergenic",0,"Human",0.029787234,7274658
"5:78433204:<DEL>:315:461.68:Lumpy:Both:0.004","<DEL>","5",78433204,315,"intergenic",0,"Human",0.004255319,78433519
"15:83275279:<DEL>:311:243.095:Lumpy:SVtyper:0.301","<DEL>","15",83275279,311,NA,0,"Human",0.514893617,83275590
"5:25777318:<DEL>:324:2383.23:Lumpy:SVtyper:0.826","<DEL>","5",25777318,324,"intergenic",0,"Human",0.834042553,25777642
"12:98347959:<DEL>:306:593.82:Lumpy:Both:0.004","<DEL>","12",98347959,306,"intergenic",0,"Human",0.004255319,98348265
"18:35315623:<DEL>:318:449.54:Lumpy:SVtyper:0.007","<DEL>","18",35315623,318,"intergenic",0,"Human",0.017021277,35315941
"5:142935377:<DEL>:312:748.61:Lumpy:SVtyper:0.562","<DEL>","5",142935377,312,"intergenic",0,"Human",0.74893617,142935689
"15:91402103:<DEL>:313:986.775:Lumpy:SVtyper:0.283","<DEL>","15",91402103,313,"intergenic",0,"Human",0.429787234,91402416
"8:140971207:<DEL>:310:182.955:Lumpy:SVtyper:0.004","<DEL>","8",140971207,310,NA,0,"Human",0.004255319,140971517
"18:55671128:<DEL>:306:204.13:Lumpy:SVtyper:0.007","<DEL>","18",55671128,306,"intergenic",0,"Human",0.012765957,55671434
"16:1886492:<DEL>:306:765.06:Lumpy:SVtyper:0.029","<DEL>","16",1886492,306,NA,0,"Human",0.063829787,1886798
"1:225344402:<DEL>:314:688.745:Lumpy:SVtyper:0.098","<DEL>","1",225344402,314,NA,0,"Human",0.161702128,225344716
"5:78277729:<DEL>:319:2216.585:Lumpy:SVtyper:0.525","<DEL>","5",78277729,319,NA,0,"Human",0.680851064,78278048
"8:30392282:<DEL>:305:1796.235:Lumpy:SVtyper:0.844","<DEL>","8",30392282,305,NA,0,"Human",0.859574468,30392587
"5:11339029:<DEL>:324:2335.445:Lumpy:SVtyper:0.467","<DEL>","5",11339029,324,NA,0,"Human",0.787234043,11339353
"11:14348313:<DEL>:316:720.56:Lumpy:SVtyper:0.007","<DEL>","11",14348313,316,NA,0,"Human",0.012765957,14348629
"7:81955926:<DEL>:284:797.555:Lumpy:SVtyper:0.221","<DEL>","7",81955926,284,NA,0,"Human",0.404255319,81956210
"14:51601405:<DEL>:303:1809.69:Lumpy:SVtyper:0.246","<DEL>","14",51601405,303,"intergenic",0,"Human",0.378723404,51601708
"6:95181588:<DEL>:307:747.94:Lumpy:SVtyper:0.004","<DEL>","6",95181588,307,"intergenic",0,"Human",0.008510638,95181895
"6:65185153:<DEL>:314:1039.18:Lumpy:SVtyper:0.272","<DEL>","6",65185153,314,NA,0,"Human",0.446808511,65185467
"19:8608480:<DEL>:276:208.46:Lumpy:SVtyper:0.007","<DEL>","19",8608480,276,NA,0,"Human",0.012765957,8608756
"18:77168878:<DEL>:282:505.09:Lumpy:SVtyper:0.105","<DEL>","18",77168878,282,NA,0,"Human",0.157446809,77169160
"3:193154601:<DEL>:312:503.07:Lumpy:SVtyper:0.004","<DEL>","3",193154601,312,NA,0,"Human",0.008510638,193154913
"6:153742972:<DEL>:306:261.42:Lumpy:SVtyper:0.217","<DEL>","6",153742972,306,"intergenic",0,"Human",0.459574468,153743278
"9:71944725:<DEL>:279:616.19:Lumpy:SVtyper:0.004","<DEL>","9",71944725,279,NA,0,"Human",0.008510638,71945004
"20:14529076:<DEL>:313:1049.565:Lumpy:SVtyper:0.627","<DEL>","20",14529076,313,NA,0,"Human",0.787234043,14529389
"9:132191079:<DEL>:325:189.29:Lumpy:SVtyper:0.004","<DEL>","9",132191079,325,"intergenic",0,"Human",0.012765957,132191404
"20:53292658:<DEL>:314:1604.16:Lumpy:SVtyper:0.645","<DEL>","20",53292658,314,"intergenic",0,"Human",0.808510638,53292972
"8:15001277:<DEL>:320:941.56:Lumpy:SVtyper:0.808","<DEL>","8",15001277,320,NA,0,"Human",0.834042553,15001597
"11:46617690:<DEL>:323:213.445:Lumpy:SVtyper:0.004","<DEL>","11",46617690,323,"intergenic",0,"Human",0.004255319,46618013
"20:59974170:<DEL>:322:997.795:Lumpy:SVtyper:0.330","<DEL>","20",59974170,322,NA,0,"Human",0.519148936,59974492
"X:116454347:<DEL>:319:1199.51:Lumpy:SVtyper:0.280","<DEL>","X",116454347,319,"intergenic",0,"Human",0.378723404,116454666
"12:113824026:<DEL>:286:744.29:Lumpy:SVtyper:0.007","<DEL>","12",113824026,286,NA,0,"Human",0.017021277,113824312
"11:60964421:<DEL>:278:730.27:Lumpy:SVtyper:0.011","<DEL>","11",60964421,278,"intergenic",0,"Human",0.021276596,60964699
"2:206731192:<DEL>:323:2659.765:Lumpy:SVtyper:0.826","<DEL>","2",206731192,323,"intergenic",0,"Human",0.859574468,206731515
"1:56887706:<DEL>:317:1433.22:Lumpy:SVtyper:0.645","<DEL>","1",56887706,317,"intergenic",0,"Human",0.774468085,56888023
"12:94669337:<DEL>:318:408.28:Lumpy:SVtyper:0.156","<DEL>","12",94669337,318,NA,0,"Human",0.289361702,94669655
"16:82077006:<DEL>:322:877.115:Lumpy:SVtyper:0.018","<DEL>","16",82077006,322,NA,0,"Human",0.038297872,82077328
"2:117334933:<DEL>:316:1116.455:Lumpy:SVtyper:0.004","<DEL>","2",117334933,316,"intergenic",0,"Human",0.004255319,117335249
"7:157841393:<DUP>:287:376.665:Lumpy:SVtyper:0.457","<DUP>","7",157841393,287,NA,0,"Human",0.914893617,157841680
"11:4802527:<DEL>:311:289.62:Lumpy:SVtyper:0.188","<DEL>","11",4802527,311,"intergenic",0,"Human",0.310638298,4802838
"13:114579403:<DEL>:306:573.6:Lumpy:SVtyper:0.319","<DEL>","13",114579403,306,"intergenic",0,"Human",0.574468085,114579709
"13:107924542:<DEL>:323:2339:Lumpy:SVtyper:0.558","<DEL>","13",107924542,323,NA,0,"Human",0.714893617,107924865
"15:79911587:<DEL>:312:771.26:Lumpy:SVtyper:0.004","<DEL>","15",79911587,312,"intergenic",0,"Human",0.008510638,79911899
"4:84221711:<DEL>:285:1590.95:Lumpy:SVtyper:0.594","<DEL>","4",84221711,285,NA,0,"Human",0.876595745,84221996
"5:6524380:<DEL>:319:441.45:Lumpy:SVtyper:0.029","<DEL>","5",6524380,319,"intergenic",0,"Human",0.059574468,6524699
"5:99978683:<DEL>:303:1231.60:Lumpy:Both:0.007","<DEL>","5",99978683,303,"intergenic",0,"Human",0.012765957,99978986
"2:209061160:<DEL>:320:2568.53:Lumpy:SVtyper:0.764","<DEL>","2",209061160,320,"intergenic",0,"Human",0.834042553,209061480
"16:57252627:<DEL>:323:588.42:Lumpy:SVtyper:0.054","<DEL>","16",57252627,323,NA,0,"Human",0.10212766,57252950
"19:23986393:<DEL>:324:2066.15:Lumpy:SVtyper:0.830","<DEL>","19",23986393,324,"intergenic",0,"Human",0.834042553,23986717
"6:154686520:<DEL>:276:782.19:Lumpy:SVtyper:0.221","<DEL>","6",154686520,276,"intergenic",0,"Human",0.395744681,154686796
"18:64542934:<DEL>:321:514.535:Lumpy:SVtyper:0.362","<DEL>","18",64542934,321,"intergenic",0,"Human",0.591489362,64543255
"5:31677434:<DEL>:321:1875.33:Lumpy:SVtyper:0.757","<DEL>","5",31677434,321,"intergenic",0,"Human",0.817021277,31677755
"3:128263202:<DEL>:300:522.075:Lumpy:SVtyper:0.022","<DEL>","3",128263202,300,"intergenic",0,"Human",0.034042553,128263502
"2:128871262:<DEL>:310:2022.27:Lumpy:SVtyper:0.786","<DEL>","2",128871262,310,NA,0,"Human",0.855319149,128871572
"4:190253845:<DEL>:322:2202.74:Lumpy:SVtyper:0.014","<DEL>","4",190253845,322,"intergenic",0,"Human",0.012765957,190254167
"8:42185318:<DEL>:312:1229.32:Lumpy:SVtyper:0.630","<DEL>","8",42185318,312,NA,0,"Human",0.736170213,42185630
"9:136414107:<DEL>:324:2110.38:Lumpy:SVtyper:0.007","<DEL>","9",136414107,324,NA,0,"Human",0.017021277,136414431
"9:83630440:<DEL>:313:727.58:Lumpy:SVtyper:0.014","<DEL>","9",83630440,313,"intergenic",0,"Human",0.012765957,83630753
"5:89003721:<DEL>:324:932.93:Lumpy:Both:0.011","<DEL>","5",89003721,324,"intergenic",0,"Human",0.017021277,89004045
"6:24879113:<DEL>:312:706.54:Lumpy:SVtyper:0.188","<DEL>","6",24879113,312,NA,0,"Human",0.382978723,24879425
"19:58921910:<DEL>:281:175.90:Lumpy:SVtyper:0.007","<DEL>","19",58921910,281,NA,0,"Human",0.004255319,58922191
"8:110510311:<DEL>:322:705.19:Lumpy:SVtyper:0.290","<DEL>","8",110510311,322,NA,0,"Human",0.50212766,110510633
"9:75669523:<DEL>:279:1966.92:Lumpy:SVtyper:0.011","<DEL>","9",75669523,279,"intergenic",0,"Human",0.012765957,75669802
"18:9385396:<DEL>:324:243.09:Lumpy:SVtyper:0.007","<DEL>","18",9385396,324,NA,0,"Human",0.017021277,9385720
"8:6362860:<DEL>:282:223.95:Lumpy:SVtyper:0.036","<DEL>","8",6362860,282,NA,0,"Human",0.085106383,6363142
"17:65727367:<DEL>:276:1424.43:Lumpy:SVtyper:0.007","<DEL>","17",65727367,276,NA,0,"Human",0.012765957,65727643
"1:169730409:<DEL>:315:594.63:Lumpy:SVtyper:0.076","<DEL>","1",169730409,315,"intergenic",0,"Human",0.119148936,169730724
"7:138742278:<DEL>:317:596.245:Lumpy:SVtyper:0.460","<DEL>","7",138742278,317,NA,0,"Human",0.638297872,138742595
"1:217404342:<DEL>:313:342.345:Lumpy:SVtyper:0.047","<DEL>","1",217404342,313,"intergenic",0,"Human",0.085106383,217404655
"1:69943718:<DEL>:306:502.79:Lumpy:SVtyper:0.605","<DEL>","1",69943718,306,"intergenic",0,"Human",0.74893617,69944024
"2:856578:<DEL>:292:498.22:Lumpy:SVtyper:0.011","<DEL>","2",856578,292,"intergenic",0,"Human",0.017021277,856870
"4:263969:<DEL>:281:273.71:Lumpy:SVtyper:0.007","<DEL>","4",263969,281,NA,0,"Human",0.012765957,264250
"18:22892485:<DEL>:324:333.04:Lumpy:SVtyper:0.007","<DEL>","18",22892485,324,NA,0,"Human",0.021276596,22892809
"1:44823392:<DEL>:299:575.21:Lumpy:SVtyper:0.029","<DEL>","1",44823392,299,"intergenic",0,"Human",0.063829787,44823691
"7:113953506:<DEL>:312:1032.05:Lumpy:SVtyper:0.236","<DEL>","7",113953506,312,"intergenic",0,"Human",0.429787234,113953818
"3:80657204:<DEL>:321:196.58:Lumpy:SVtyper:0.011","<DEL>","3",80657204,321,"intergenic",0,"Human",0.017021277,80657525
"8:145005302:<DEL>:283:365.12:Lumpy:SVtyper:0.007","<DEL>","8",145005302,283,NA,0,"Human",0.008510638,145005585
"12:132640534:<DUP>:297:189.435:Lumpy:SVtyper:0.004","<DUP>","12",132640534,297,"intergenic",0,"Human",0.008510638,132640831
"19:22768154:<DEL>:323:369.98:Lumpy:SVtyper:0.065","<DEL>","19",22768154,323,"intergenic",0,"Human",0.119148936,22768477
"6:115624539:<DEL>:317:742.68:Lumpy:SVtyper:0.449","<DEL>","6",115624539,317,"intergenic",0,"Human",0.65106383,115624856
"11:103410823:<DEL>:313:2431.37:Lumpy:SVtyper:0.815","<DEL>","11",103410823,313,"intergenic",0,"Human",0.834042553,103411136
"10:50278016:<DEL>:317:706.68:Lumpy:SVtyper:0.286","<DEL>","10",50278016,317,NA,0,"Human",0.455319149,50278333
"6:130959403:<DEL>:320:701.95:Lumpy:SVtyper:0.007","<DEL>","6",130959403,320,"intergenic",0,"Human",0.012765957,130959723
"3:189575903:<DEL>:322:4240.705:Lumpy:SVtyper:0.551","<DEL>","3",189575903,322,NA,0,"Human",0.706382979,189576225
"12:286267:<DEL>:283:126.33:Lumpy:SVtyper:0.014","<DEL>","12",286267,283,NA,0,"Human",0.017021277,286550
"11:16597570:<DEL>:323:1121.575:Lumpy:SVtyper:0.007","<DEL>","11",16597570,323,"intergenic",0,"Human",0.012765957,16597893
"5:78276759:<DEL>:324:1003.725:Lumpy:SVtyper:0.007","<DEL>","5",78276759,324,NA,0,"Human",0.012765957,78277083
"14:83019611:<DEL>:281:2565.94:Lumpy:SVtyper:0.011","<DEL>","14",83019611,281,"intergenic",0,"Human",0.012765957,83019892
"4:70880570:<DEL>:310:817.10:Lumpy:SVtyper:0.014","<DEL>","4",70880570,310,"intergenic",0,"Human",0.025531915,70880880
"1:180292998:<DEL>:324:1196.27:Lumpy:SVtyper:0.014","<DEL>","1",180292998,324,NA,0,"Human",0.029787234,180293322
"13:114743550:<DEL>:276:543.665:Lumpy:SVtyper:0.022","<DEL>","13",114743550,276,"intergenic",0,"Human",0.046808511,114743826
"13:96633430:<DEL>:318:2295.68:Lumpy:SVtyper:0.790","<DEL>","13",96633430,318,NA,0,"Human",0.782978723,96633748
"18:35315623:<DEL>:318:379.15:Lumpy:SVtyper:0.007","<DEL>","18",35315623,318,"intergenic",0,"Human",0.012765957,35315941
"13:107924542:<DEL>:323:549.845:Lumpy:SVtyper:0.007","<DEL>","13",107924542,323,NA,0,"Human",0.012765957,107924865
"2:174198583:<DEL>:322:383.46:Lumpy:SVtyper:0.243","<DEL>","2",174198583,322,"intergenic",0,"Human",0.417021277,174198905
"4:9956826:<DEL>:314:754.81:Lumpy:SVtyper:0.366","<DEL>","4",9956826,314,NA,0,"Human",0.553191489,9957140
"6:138947743:<DEL>:320:910.41:Lumpy:SVtyper:0.199","<DEL>","6",138947743,320,"intergenic",0,"Human",0.353191489,138948063
"1:241360538:<DEL>:315:1257.34:Lumpy:SVtyper:0.674","<DEL>","1",241360538,315,NA,0,"Human",0.778723404,241360853
"19:7736241:<DUP>:277:126.915:Lumpy:SVtyper:0.007","<DUP>","19",7736241,277,NA,0,"Human",0.012765957,7736518
"2:37746816:<DEL>:316:244.585:Lumpy:SVtyper:0.014","<DEL>","2",37746816,316,"intergenic",0,"Human",0.038297872,37747132
"2:22278001:<DEL>:294:373.23:Lumpy:SVtyper:0.011","<DEL>","2",22278001,294,"intergenic",0,"Human",0.021276596,22278295
"4:189793244:<DEL>:319:978.36:Lumpy:SVtyper:0.011","<DEL>","4",189793244,319,"intergenic",0,"Human",0.025531915,189793563
"2:31342738:<DEL>:315:896.66:Lumpy:SVtyper:0.261","<DEL>","2",31342738,315,NA,0,"Human",0.446808511,31343053
"9:112430208:<DEL>:315:1785.17:Lumpy:SVtyper:0.507","<DEL>","9",112430208,315,NA,0,"Human",0.710638298,112430523
"13:23330162:<DEL>:287:479.2:Lumpy:SVtyper:0.004","<DEL>","13",23330162,287,"intergenic",0,"Human",0.008510638,23330449
"11:27789528:<DEL>:293:356.77:Lumpy:SVtyper:0.004","<DEL>","11",27789528,293,"intergenic",0,"Human",0.004255319,27789821
"2:117334933:<DEL>:316:564.42:Lumpy:SVtyper:0.091","<DEL>","2",117334933,316,"intergenic",0,"Human",0.187234043,117335249
"3:71242344:<DEL>:301:551.615:Lumpy:SVtyper:0.087","<DEL>","3",71242344,301,NA,0,"Human",0.195744681,71242645
"6:75957788:<DEL>:319:389.79:Lumpy:SVtyper:0.007","<DEL>","6",75957788,319,"intergenic",0,"Human",0.017021277,75958107
"3:190696628:<DEL>:321:893.97:Lumpy:SVtyper:0.062","<DEL>","3",190696628,321,"intergenic",0,"Human",0.131914894,190696949
"2:77976783:<DEL>:324:879.925:Lumpy:SVtyper:0.145","<DEL>","2",77976783,324,"intergenic",0,"Human",0.25106383,77977107
"5:99923539:<DEL>:305:1523.94:Lumpy:SVtyper:0.301","<DEL>","5",99923539,305,"intergenic",0,"Human",0.553191489,99923844
"13:105161215:<DEL>:314:1681:Lumpy:SVtyper:0.620","<DEL>","13",105161215,314,"intergenic",0,"Human",0.791489362,105161529
"10:58302961:<DUP>:309:181.30:Lumpy:SVtyper:0.261","<DUP>","10",58302961,309,"intergenic",0,"Human",0.540425532,58303270
"4:97572103:<DEL>:319:505.085:Lumpy:SVtyper:0.004","<DEL>","4",97572103,319,"intergenic",0,"Human",0.008510638,97572422
"X:105191165:<DEL>:303:855.815:Lumpy:SVtyper:0.213","<DEL>","X",105191165,303,NA,0,"Human",0.276595745,105191468
"6:168376915:<DEL>:318:671.76:Lumpy:SVtyper:0.014","<DEL>","6",168376915,318,"NM_001129895;HGC6.3;1/1_exons",1,"Human",0.029787234,168377233
"12:38211210:<DEL>:319:459.52:Lumpy:SVtyper:0.004","<DEL>","12",38211210,319,"intergenic",0,"Human",0.004255319,38211529
"8:76126894:<DEL>:324:1875.70:Lumpy:SVtyper:0.007","<DEL>","8",76126894,324,"intergenic",0,"Human",0.012765957,76127218
"12:79323178:<DEL>:306:578.71:Lumpy:SVtyper:0.004","<DEL>","12",79323178,306,NA,0,"Human",0.004255319,79323484
"8:27684017:<DEL>:318:726.76:Lumpy:SVtyper:0.116","<DEL>","8",27684017,318,NA,0,"Human",0.212765957,27684335
"1:42743185:<DEL>:315:151.27:Lumpy:SVtyper:0.348","<DEL>","1",42743185,315,NA,0,"Human",0.629787234,42743500
"7:153395552:<DEL>:299:807.455:Lumpy:SVtyper:0.029","<DEL>","7",153395552,299,"intergenic",0,"Human",0.05106383,153395851
"3:162408300:<DEL>:316:718.13:Lumpy:SVtyper:0.583","<DEL>","3",162408300,316,"intergenic",0,"Human",0.69787234,162408616
"10:129946569:<DEL>:320:379.94:Lumpy:SVtyper:0.004","<DEL>","10",129946569,320,"intergenic",0,"Human",0.004255319,129946889
"9:83187758:<DUP>:321:552.885:Lumpy:SVtyper:0.105","<DUP>","9",83187758,321,"intergenic",0,"Human",0.204255319,83188079
"5:75995512:<DEL>:280:706.54:Lumpy:SVtyper:0.040","<DEL>","5",75995512,280,NA,0,"Human",0.072340426,75995792
"5:5778097:<DEL>:306:358.11:Lumpy:SVtyper:0.004","<DEL>","5",5778097,306,"intergenic",0,"Human",0.008510638,5778403
"8:61194947:<DEL>:291:663.925:Lumpy:SVtyper:0.004","<DEL>","8",61194947,291,NA,0,"Human",0.008510638,61195238
"20:7274345:<DEL>:313:2058.935:Lumpy:SVtyper:0.007","<DEL>","20",7274345,313,"intergenic",0,"Human",0.012765957,7274658
"9:24356422:<DEL>:318:1483.49:Lumpy:SVtyper:0.051","<DEL>","9",24356422,318,"intergenic",0,"Human",0.10212766,24356740
"14:83019611:<DEL>:281:1271.52:Lumpy:SVtyper:0.011","<DEL>","14",83019611,281,"intergenic",0,"Human",0.012765957,83019892
"1:73753601:<DEL>:315:980.25:Lumpy:SVtyper:0.007","<DEL>","1",73753601,315,"intergenic",0,"Human",0.012765957,73753916
"13:44044206:<DEL>:321:173.8:Lumpy:SVtyper:0.007","<DEL>","13",44044206,321,NA,0,"Human",0.012765957,44044527
"8:38953604:<DEL>:278:677.68:Lumpy:SVtyper:0.109","<DEL>","8",38953604,278,NA,0,"Human",0.195744681,38953882
"1:185766811:<DEL>:323:585.45:Lumpy:SVtyper:0.004","<DEL>","1",185766811,323,NA,0,"Human",0.004255319,185767134
"3:190669801:<DEL>:323:781.105:Lumpy:SVtyper:0.243","<DEL>","3",190669801,323,"intergenic",0,"Human",0.438297872,190670124
"3:49197754:<DEL>:323:780.565:Lumpy:SVtyper:0.446","<DEL>","3",49197754,323,"intergenic",0,"Human",0.65106383,49198077
"11:16597570:<DEL>:323:3302.67:Lumpy:SVtyper:0.826","<DEL>","11",16597570,323,"intergenic",0,"Human",0.829787234,16597893
"6:68353223:<DEL>:285:976.22:Lumpy:SVtyper:0.062","<DEL>","6",68353223,285,"intergenic",0,"Human",0.131914894,68353508
"19:49889478:<DEL>:324:243.51:Lumpy:SVtyper:0.127","<DEL>","19",49889478,324,"intergenic",0,"Human",0.263829787,49889802
"18:32530960:<DEL>:277:1737.42:Lumpy:SVtyper:0.728","<DEL>","18",32530960,277,"intergenic",0,"Human",0.94893617,32531237
"4:98590657:<DEL>:318:865.10:Lumpy:SVtyper:0.438","<DEL>","4",98590657,318,NA,0,"Human",0.65106383,98590975
"16:54660366:<DEL>:309:656.24:Lumpy:SVtyper:0.156","<DEL>","16",54660366,309,"intergenic",0,"Human",0.306382979,54660675
"2:241991949:<DEL>:324:109.075:Lumpy:SVtyper:0.004","<DEL>","2",241991949,324,NA,0,"Human",0.008510638,241992273
"4:39814955:<DEL>:321:354.08:Lumpy:SVtyper:0.304","<DEL>","4",39814955,321,"intergenic",0,"Human",0.604255319,39815276
"9:87503890:<DEL>:319:659.61:Lumpy:SVtyper:0.004","<DEL>","9",87503890,319,NA,0,"Human",0.008510638,87504209
"8:89392210:<DEL>:313:2080.34:Lumpy:SVtyper:0.754","<DEL>","8",89392210,313,"intergenic",0,"Human",0.812765957,89392523
"9:136130451:<DUP>:294:177.72:Lumpy:SVtyper:0.047","<DUP>","9",136130451,294,NA,0,"Human",0.09787234,136130745
"6:55262030:<DEL>:318:569.94:Lumpy:SVtyper:0.018","<DEL>","6",55262030,318,NA,0,"Human",0.042553191,55262348
"2:212551248:<DEL>:297:2036.63:Lumpy:SVtyper:0.779","<DEL>","2",212551248,297,NA,0,"Human",0.808510638,212551545
"14:42486330:<DEL>:315:895.84:Lumpy:SVtyper:0.011","<DEL>","14",42486330,315,"intergenic",0,"Human",0.021276596,42486645
"5:80039380:<DEL>:309:633.73:Lumpy:SVtyper:0.605","<DEL>","5",80039380,309,NA,0,"Human",0.782978723,80039689
"4:117420642:<DEL>:279:421.23:Lumpy:SVtyper:0.279","<DEL>","4",117420642,279,"intergenic",0,"Human",0.480851064,117420921
"8:94618785:<DEL>:302:751.57:Lumpy:SVtyper:0.014","<DEL>","8",94618785,302,"intergenic",0,"Human",0.017021277,94619087
"3:188779394:<DEL>:284:823.31:Lumpy:SVtyper:0.007","<DEL>","3",188779394,284,"intergenic",0,"Human",0.012765957,188779678
"8:2178928:<DEL>:323:998.2:Lumpy:SVtyper:0.062","<DEL>","8",2178928,323,"intergenic",0,"Human",0.119148936,2179251
"17:5464743:<DEL>:324:353.53:Lumpy:SVtyper:0.409","<DEL>","17",5464743,324,NA,0,"Human",0.621276596,5465067
"5:98585422:<DEL>:307:744.29:Lumpy:SVtyper:0.018","<DEL>","5",98585422,307,"intergenic",0,"Human",0.034042553,98585729
"21:40344318:<DEL>:322:450.89:Lumpy:SVtyper:0.043","<DEL>","21",40344318,322,"intergenic",0,"Human",0.085106383,40344640
"21:47048969:<DEL>:297:133.34:Lumpy:SVtyper:0.004","<DEL>","21",47048969,297,"intergenic",0,"Human",0.008510638,47049266
"6:32593711:<DEL>:314:923.09:Lumpy:Both:0.007","<DEL>","6",32593711,314,"intergenic",0,"Human",0.017021277,32594025
"21:43677979:<DEL>:285:831.52:Lumpy:SVtyper:0.076","<DEL>","21",43677979,285,NA,0,"Human",0.10212766,43678264
"19:466973:<DUP>:283:177.35:Lumpy:SVtyper:0.025","<DUP>","19",466973,283,NA,0,"Human",0.042553191,467256
"13:70459059:<DEL>:314:780.69:Lumpy:SVtyper:0.014","<DEL>","13",70459059,314,NA,0,"Human",0.038297872,70459373
"3:19172939:<DEL>:289:610.00:Lumpy:SVtyper:0.011","<DEL>","3",19172939,289,"intergenic",0,"Human",0.017021277,19173228
"5:16753531:<DEL>:304:547.7:Lumpy:SVtyper:0.004","<DEL>","5",16753531,304,NA,0,"Human",0.008510638,16753835
"4:163062247:<DEL>:319:621.31:Lumpy:SVtyper:0.141","<DEL>","4",163062247,319,NA,0,"Human",0.268085106,163062566
"2:122564387:<DEL>:317:1015.77:Lumpy:SVtyper:0.033","<DEL>","2",122564387,317,"intergenic",0,"Human",0.05106383,122564704
"7:127766426:<DEL>:314:1020.72:Lumpy:Both:0.004","<DEL>","7",127766426,314,"intergenic",0,"Human",0.004255319,127766740
"17:64930551:<DEL>:316:1157.445:Lumpy:SVtyper:0.395","<DEL>","17",64930551,316,"intergenic",0,"Human",0.6,64930867
"10:84048937:<DEL>:324:901.105:Lumpy:SVtyper:0.018","<DEL>","10",84048937,324,NA,0,"Human",0.038297872,84049261
"4:120013804:<DEL>:324:1778.36:Lumpy:SVtyper:0.112","<DEL>","4",120013804,324,"intergenic",0,"Human",0.191489362,120014128
"4:181549429:<DEL>:314:500.505:Lumpy:SVtyper:0.007","<DEL>","4",181549429,314,"intergenic",0,"Human",0.021276596,181549743
"2:82340457:<DEL>:320:686.99:Lumpy:SVtyper:0.018","<DEL>","2",82340457,320,"intergenic",0,"Human",0.034042553,82340777
"3:103547914:<DEL>:319:646.67:Lumpy:SVtyper:0.370","<DEL>","3",103547914,319,"intergenic",0,"Human",0.561702128,103548233
"5:140169065:<DEL>:305:548.24:Lumpy:SVtyper:0.004","<DEL>","5",140169065,305,NA,0,"Human",0.008510638,140169370
"13:23557664:<DEL>:325:881.96:Lumpy:SVtyper:0.004","<DEL>","13",23557664,325,"intergenic",0,"Human",0.004255319,23557989
"2:170992023:<DEL>:309:1456.645:Lumpy:SVtyper:0.522","<DEL>","2",170992023,309,"intergenic",0,"Human",0.689361702,170992332
"4:133619883:<DEL>:307:2369.41:Lumpy:SVtyper:0.681","<DEL>","4",133619883,307,"intergenic",0,"Human",0.812765957,133620190
"17:67087662:<DEL>:311:566.03:Lumpy:SVtyper:0.004","<DEL>","17",67087662,311,NA,0,"Human",0.008510638,67087973
"21:30234675:<DEL>:310:740.79:Lumpy:SVtyper:0.062","<DEL>","21",30234675,310,"intergenic",0,"Human",0.10212766,30234985
"15:58912857:<DEL>:318:517.49:Lumpy:SVtyper:0.341","<DEL>","15",58912857,318,NA,0,"Human",0.561702128,58913175
"14:87555893:<DEL>:321:529.09:Lumpy:SVtyper:0.007","<DEL>","14",87555893,321,"intergenic",0,"Human",0.012765957,87556214
"10:69823519:<DEL>:292:667.71:Lumpy:SVtyper:0","<DEL>","10",69823519,292,NA,0,"Human",0.004255319,69823811
"18:50925991:<DEL>:323:2390.215:Lumpy:SVtyper:0.014","<DEL>","18",50925991,323,NA,0,"Human",0.012765957,50926314
"8:106670520:<DEL>:320:574.535:Lumpy:SVtyper:0.007","<DEL>","8",106670520,320,NA,0,"Human",0.012765957,106670840
"3:133204752:<DEL>:323:1220.01:Lumpy:SVtyper:0.004","<DEL>","3",133204752,323,"intergenic",0,"Human",0.008510638,133205075
"4:186198866:<DEL>:319:695.21:Lumpy:SVtyper:0.004","<DEL>","4",186198866,319,NA,0,"Human",0.008510638,186199185
"8:127248960:<DEL>:323:575.885:Lumpy:SVtyper:0.587","<DEL>","8",127248960,323,"intergenic",0,"Human",0.880851064,127249283
"1:46803348:<DEL>:292:700.07:Lumpy:SVtyper:0.004","<DEL>","1",46803348,292,"intergenic",0,"Human",0.008510638,46803640
"16:82077006:<DEL>:322:634.135:Lumpy:SVtyper:0.004","<DEL>","16",82077006,322,NA,0,"Human",0.004255319,82077328
"3:60480985:<DUP>:304:142.765:Lumpy:SVtyper:0.004","<DUP>","3",60480985,304,NA,0,"Human",0.008510638,60481289
"4:110498743:<DEL>:325:1357.82:Lumpy:SVtyper:0.478","<DEL>","4",110498743,325,NA,0,"Human",0.706382979,110499068
"7:156242110:<DUP>:279:609.85:Lumpy:SVtyper:0.004","<DUP>","7",156242110,279,"intergenic",0,"Human",0.008510638,156242389
"12:7977834:<DEL>:313:510.625:Lumpy:SVtyper:0.029","<DEL>","12",7977834,313,NA,0,"Human",0.055319149,7978147
"6:160929083:<DEL>:315:396.68:Lumpy:SVtyper:0.004","<DEL>","6",160929083,315,"intergenic",0,"Human",0.012765957,160929398
"4:130590926:<DEL>:291:987.27:Lumpy:SVtyper:0.366","<DEL>","4",130590926,291,"intergenic",0,"Human",0.544680851,130591217
"1:96482878:<DEL>:286:175.27:Lumpy:SVtyper:0.007","<DEL>","1",96482878,286,"intergenic",0,"Human",0.008510638,96483164
"10:7420113:<DEL>:303:407.20:Lumpy:SVtyper:0.033","<DEL>","10",7420113,303,NA,0,"Human",0.059574468,7420416
"18:828485:<DEL>:323:323.88:Lumpy:SVtyper:0.036","<DEL>","18",828485,323,"intergenic",0,"Human",0.076595745,828808
"2:1801672:<DEL>:299:1326.66:Lumpy:SVtyper:0.279","<DEL>","2",1801672,299,NA,0,"Human",0.442553191,1801971
"2:183315820:<DEL>:315:1396.68:Lumpy:SVtyper:0.007","<DEL>","2",183315820,315,NA,0,"Human",0.012765957,183316135
"15:79616715:<DUP>:305:544.04:Lumpy:SVtyper:0.004","<DUP>","15",79616715,305,"intergenic",0,"Human",0.008510638,79617020
"1:185437290:<DEL>:310:434.43:Lumpy:SVtyper:0.007","<DEL>","1",185437290,310,"intergenic",0,"Human",0.012765957,185437600
"9:36309289:<DEL>:321:159.5:Lumpy:SVtyper:0.004","<DEL>","9",36309289,321,"intergenic",0,"Human",0.004255319,36309610
"3:4661239:<DEL>:314:192.675:Lumpy:SVtyper:0.007","<DEL>","3",4661239,314,NA,0,"Human",0.008510638,4661553
"X:138941973:<DEL>:322:643.70:Lumpy:SVtyper:0.097","<DEL>","X",138941973,322,"intergenic",0,"Human",0.110638298,138942295
"4:134141607:<DEL>:305:2041.445:Lumpy:SVtyper:0.764","<DEL>","4",134141607,305,"intergenic",0,"Human",0.829787234,134141912
"19:51776400:<DEL>:311:877.52:Lumpy:SVtyper:0.178","<DEL>","19",51776400,311,"intergenic",0,"Human",0.310638298,51776711
"15:97953315:<DEL>:312:687.39:Lumpy:SVtyper:0.022","<DEL>","15",97953315,312,"intergenic",0,"Human",0.055319149,97953627
"5:55870784:<DEL>:295:752.92:Both:Both:0.022","<DEL>","5",55870784,295,NA,0,"Human",0.046808511,55871079
"6:55492681:<DEL>:303:503.075:Lumpy:SVtyper:0.007","<DEL>","6",55492681,303,"intergenic",0,"Human",0.017021277,55492984
"1:231303066:<DEL>:306:709.24:Lumpy:SVtyper:0.080","<DEL>","1",231303066,306,NA,0,"Human",0.153191489,231303372
"9:36588198:<DEL>:279:493.905:Lumpy:SVtyper:0.004","<DEL>","9",36588198,279,NA,0,"Human",0.008510638,36588477
"4:163062247:<DEL>:319:1248.05:Lumpy:SVtyper:0.007","<DEL>","4",163062247,319,NA,0,"Human",0.008510638,163062566
"1:58343213:<DEL>:324:1175.51:Lumpy:SVtyper:0.011","<DEL>","1",58343213,324,NA,0,"Human",0.021276596,58343537
"10:86476041:<DEL>:324:927.815:Lumpy:SVtyper:0.004","<DEL>","10",86476041,324,"intergenic",0,"Human",0.008510638,86476365
"4:127640382:<DEL>:318:931.585:Lumpy:SVtyper:0.029","<DEL>","4",127640382,318,"intergenic",0,"Human",0.055319149,127640700
"13:82274971:<DEL>:314:820.88:Lumpy:SVtyper:0.004","<DEL>","13",82274971,314,"intergenic",0,"Human",0.004255319,82275285
"3:99037449:<DEL>:312:779.61:Lumpy:SVtyper:0.007","<DEL>","3",99037449,312,"intergenic",0,"Human",0.017021277,99037761
"4:135927541:<DEL>:321:832.74:Lumpy:SVtyper:0.286","<DEL>","4",135927541,321,"intergenic",0,"Human",0.468085106,135927862
"2:175090635:<DEL>:320:1449.24:Lumpy:SVtyper:0.435","<DEL>","2",175090635,320,NA,0,"Human",0.629787234,175090955
"8:115887866:<DEL>:279:307.56:Lumpy:SVtyper:0.004","<DEL>","8",115887866,279,"intergenic",0,"Human",0.004255319,115888145
"14:81597045:<DEL>:319:1265.175:Lumpy:SVtyper:0.076","<DEL>","14",81597045,319,NA,0,"Human",0.123404255,81597364
"14:64006754:<DEL>:306:927.68:Lumpy:SVtyper:0.004","<DEL>","14",64006754,306,NA,0,"Human",0.008510638,64007060
"12:128932247:<DEL>:299:527.87:Lumpy:SVtyper:0.007","<DEL>","12",128932247,299,NA,0,"Human",0.012765957,128932546
"4:81991526:<DEL>:324:758.85:Lumpy:SVtyper:0.786","<DEL>","4",81991526,324,"intergenic",0,"Human",0.846808511,81991850
"8:6587837:<DEL>:321:848.53:Lumpy:SVtyper:0.572","<DEL>","8",6587837,321,NA,0,"Human",0.761702128,6588158
"5:119015150:<DEL>:320:1704.61:Lumpy:SVtyper:0.598","<DEL>","5",119015150,320,"intergenic",0,"Human",0.761702128,119015470
"1:1120016:<DEL>:283:590.85:Lumpy:SVtyper:0.007","<DEL>","1",1120016,283,NA,0,"Human",0.017021277,1120299
"6:38922200:<DEL>:315:1324.44:Lumpy:SVtyper:0.007","<DEL>","6",38922200,315,NA,0,"Human",0.012765957,38922515
"5:82156729:<DEL>:315:167.715:Lumpy:SVtyper:0.004","<DEL>","5",82156729,315,"intergenic",0,"Human",0.012765957,82157044
"14:66810638:<DEL>:312:700.205:Lumpy:SVtyper:0.159","<DEL>","14",66810638,312,"intergenic",0,"Human",0.272340426,66810950
"10:28112784:<DEL>:316:393.17:Lumpy:SVtyper:0.065","<DEL>","10",28112784,316,NA,0,"Human",0.119148936,28113100
"6:106928836:<DEL>:316:497.675:Lumpy:SVtyper:0.283","<DEL>","6",106928836,316,"intergenic",0,"Human",0.459574468,106929152
"7:43414126:<DEL>:319:671.49:Lumpy:SVtyper:0.207","<DEL>","7",43414126,319,NA,0,"Human",0.357446809,43414445
"2:214775207:<DEL>:307:527.06:Both:Both:0.007","<DEL>","2",214775207,307,NA,0,"Human",0.012765957,214775514
"16:34568384:<DEL>:310:751.435:Lumpy:SVtyper:0.007","<DEL>","16",34568384,310,"intergenic",0,"Human",0.017021277,34568694
"6:41404064:<DEL>:323:424.6:Lumpy:SVtyper:0.007","<DEL>","6",41404064,323,"intergenic",0,"Human",0.012765957,41404387
"6:74421257:<DEL>:306:1339.48:Lumpy:SVtyper:0.630","<DEL>","6",74421257,306,NA,0,"Human",0.787234043,74421563
"6:140952903:<DEL>:288:686.04:Lumpy:SVtyper:0.420","<DEL>","6",140952903,288,"intergenic",0,"Human",0.642553191,140953191
"2:8616801:<DEL>:307:3526.83:Lumpy:SVtyper:0.783","<DEL>","2",8616801,307,"intergenic",0,"Human",0.808510638,8617108
"4:783553:<DEL>:293:251.33:Lumpy:SVtyper:0.004","<DEL>","4",783553,293,NA,0,"Human",0.004255319,783846
"10:133975342:<DEL>:302:223.825:Lumpy:SVtyper:0.109","<DEL>","10",133975342,302,NA,0,"Human",0.221276596,133975644
"1:241360538:<DEL>:315:450.35:Lumpy:SVtyper:0.007","<DEL>","1",241360538,315,NA,0,"Human",0.012765957,241360853
"9:79124518:<DEL>:316:790.27:Lumpy:SVtyper:0.004","<DEL>","9",79124518,316,"intergenic",0,"Human",0.012765957,79124834
"8:15387297:<DEL>:303:806.59:Lumpy:SVtyper:0.047","<DEL>","8",15387297,303,"intergenic",0,"Human",0.085106383,15387600
"4:83395516:<DEL>:321:305.27:Lumpy:SVtyper:0.449","<DEL>","4",83395516,321,"intergenic",0,"Human",0.655319149,83395837
"X:4904708:<DEL>:318:1061.23:Lumpy:SVtyper:0.802","<DEL>","X",4904708,318,"intergenic",0,"Human",0.863829787,4905026
"5:25316203:<DEL>:307:1626.95:Lumpy:SVtyper:0.127","<DEL>","5",25316203,307,"intergenic",0,"Human",0.212765957,25316510
"7:89533404:<DEL>:291:832.065:Lumpy:SVtyper:0.004","<DEL>","7",89533404,291,"intergenic",0,"Human",0.008510638,89533695
"17:1062669:<DEL>:322:874.27:Lumpy:SVtyper:0.022","<DEL>","17",1062669,322,NA,0,"Human",0.046808511,1062991
"1:101388560:<DEL>:320:645.60:Lumpy:SVtyper:0.167","<DEL>","1",101388560,320,NA,0,"Human",0.327659574,101388880
"8:96390850:<DEL>:296:451.7:Lumpy:SVtyper:0.029","<DEL>","8",96390850,296,"intergenic",0,"Human",0.076595745,96391146
"1:197894019:<DEL>:296:680.65:Lumpy:SVtyper:0.471","<DEL>","1",197894019,296,NA,0,"Human",0.74893617,197894315
"3:123236751:<DEL>:315:719.34:Both:Both:0.007","<DEL>","3",123236751,315,NA,0,"Human",0.012765957,123237066
"4:69036902:<DEL>:321:2216.77:Lumpy:SVtyper:0.837","<DEL>","4",69036902,321,"intergenic",0,"Human",0.89787234,69037223
"1:95690513:<DEL>:319:1460.87:Lumpy:SVtyper:0.605","<DEL>","1",95690513,319,NA,0,"Human",0.787234043,95690832
"20:7274345:<DEL>:313:793.235:Lumpy:SVtyper:0.011","<DEL>","20",7274345,313,"intergenic",0,"Human",0.012765957,7274658
"7:108352852:<DEL>:325:1023.68:Lumpy:SVtyper:0.004","<DEL>","7",108352852,325,"intergenic",0,"Human",0.004255319,108353177
"1:217754081:<DEL>:303:825.74:Lumpy:SVtyper:0.435","<DEL>","1",217754081,303,NA,0,"Human",0.629787234,217754384
"20:11517266:<DEL>:323:786.635:Lumpy:SVtyper:0.435","<DEL>","20",11517266,323,"intergenic",0,"Human",0.617021277,11517589
"3:17731688:<DEL>:325:730:Lumpy:SVtyper:0.007","<DEL>","3",17731688,325,NA,0,"Human",0.012765957,17732013
"2:174198584:<DEL>:321:1110.51:Lumpy:SVtyper:0.004","<DEL>","2",174198584,321,"intergenic",0,"Human",0.004255319,174198905
"10:134425249:<DUP>:287:196.73:Lumpy:SVtyper:0.014","<DUP>","10",134425249,287,NA,0,"Human",0.025531915,134425536
"13:47689479:<DEL>:314:2460.86:Lumpy:SVtyper:0.014","<DEL>","13",47689479,314,"intergenic",0,"Human",0.012765957,47689793
"11:16652516:<DEL>:305:541.49:Lumpy:SVtyper:0.011","<DEL>","11",16652516,305,"intergenic",0,"Human",0.021276596,16652821
"8:137238602:<DEL>:318:508.325:Lumpy:SVtyper:0.018","<DEL>","8",137238602,318,"intergenic",0,"Human",0.029787234,137238920
"14:105738138:<DEL>:309:604.735:Lumpy:SVtyper:0.004","<DEL>","14",105738138,309,NA,0,"Human",0.008510638,105738447
"7:100939698:<DEL>:285:374.705:Lumpy:SVtyper:0.004","<DEL>","7",100939698,285,"intergenic",0,"Human",0.008510638,100939983
"12:108275481:<DEL>:306:1098.37:Lumpy:SVtyper:0.004","<DEL>","12",108275481,306,"intergenic",0,"Human",0.008510638,108275787
"8:81111366:<DEL>:310:375.92:Lumpy:SVtyper:0.004","<DEL>","8",81111366,310,"intergenic",0,"Human",0.008510638,81111676
"10:4634804:<DEL>:319:2407.01:Lumpy:SVtyper:0.833","<DEL>","10",4634804,319,"intergenic",0,"Human",0.885106383,4635123
"15:101453077:<DEL>:309:2458.27:Lumpy:SVtyper:0.460","<DEL>","15",101453077,309,NA,0,"Human",0.676595745,101453386
"4:97572103:<DEL>:319:893.16:Lumpy:SVtyper:0.301","<DEL>","4",97572103,319,"intergenic",0,"Human",0.489361702,97572422
"15:79867201:<DEL>:300:619.43:Lumpy:SVtyper:0.007","<DEL>","15",79867201,300,"intergenic",0,"Human",0.017021277,79867501
"13:74209909:<DEL>:284:909.07:Lumpy:SVtyper:0.004","<DEL>","13",74209909,284,"intergenic",0,"Human",0.008510638,74210193
"8:70357617:<DEL>:313:444.275:Lumpy:SVtyper:0.239","<DEL>","8",70357617,313,"intergenic",0,"Human",0.404255319,70357930
"17:75483519:<DEL>:305:561.325:Lumpy:SVtyper:0.007","<DEL>","17",75483519,305,"NM_006640;SEPT9;1/11_exons",1,"Human",0.012765957,75483824
"21:25286453:<DEL>:308:1352.42:Lumpy:SVtyper:0.004","<DEL>","21",25286453,308,"intergenic",0,"Human",0.008510638,25286761
"15:79891856:<DEL>:321:434.98:Lumpy:SVtyper:0.312","<DEL>","15",79891856,321,"intergenic",0,"Human",0.493617021,79892177
"20:62123517:<DUP>:318:1002.645:Lumpy:SVtyper:0.011","<DUP>","20",62123517,318,NA,0,"Human",0.017021277,62123835
"2:232245702:<DEL>:295:420.42:Lumpy:SVtyper:0.004","<DEL>","2",232245702,295,"intergenic",0,"Human",0.008510638,232245997
"8:107511104:<DEL>:325:586.665:Lumpy:SVtyper:0.014","<DEL>","8",107511104,325,NA,0,"Human",0.029787234,107511429
"6:168059214:<DEL>:324:401:Lumpy:SVtyper:0.004","<DEL>","6",168059214,324,"intergenic",0,"Human",0.004255319,168059538
"3:185590433:<DEL>:302:730.545:Lumpy:SVtyper:0.004","<DEL>","3",185590433,302,"intergenic",0,"Human",0.008510638,185590735
"7:128309227:<DEL>:325:1031.77:Lumpy:SVtyper:0.007","<DEL>","7",128309227,325,"intergenic",0,"Human",0.012765957,128309552
"20:24894142:<DEL>:312:376.99:Lumpy:SVtyper:0.007","<DEL>","20",24894142,312,"intergenic",0,"Human",0.012765957,24894454
"2:152617292:<DEL>:315:3197.925:Lumpy:SVtyper:0.018","<DEL>","2",152617292,315,"intergenic",0,"Human",0.029787234,152617607
"1:79401511:<DEL>:322:1690.34:Lumpy:SVtyper:0.500","<DEL>","1",79401511,322,NA,0,"Human",0.723404255,79401833
"2:166267517:<DEL>:324:716.51:Lumpy:SVtyper:0.007","<DEL>","2",166267517,324,"intergenic",0,"Human",0.021276596,166267841
"3:18755825:<DEL>:309:619.69:Lumpy:SVtyper:0.163","<DEL>","3",18755825,309,"intergenic",0,"Human",0.310638298,18756134
"4:55416055:<DEL>:318:179.725:Lumpy:SVtyper:0.004","<DEL>","4",55416055,318,"intergenic",0,"Human",0.004255319,55416373
"2:133873768:<DEL>:322:1064.68:Lumpy:SVtyper:0.149","<DEL>","2",133873768,322,NA,0,"Human",0.280851064,133874090
"7:103874944:<DEL>:307:855.13:Lumpy:SVtyper:0.333","<DEL>","7",103874944,307,"intergenic",0,"Human",0.540425532,103875251
"11:8871257:<DEL>:312:516.42:Lumpy:SVtyper:0.018","<DEL>","11",8871257,312,NA,0,"Human",0.05106383,8871569
"1:66079155:<DEL>:292:442.395:Lumpy:SVtyper:0.156","<DEL>","1",66079155,292,NA,0,"Human",0.276595745,66079447
"10:9301932:<DEL>:312:515.60:Lumpy:SVtyper:0.004","<DEL>","10",9301932,312,"intergenic",0,"Human",0.004255319,9302244
"17:7482639:<DEL>:295:1004.54:Lumpy:Both:0.004","<DEL>","17",7482639,295,"NM_001251;CD68;1/6_exons",1,"Human",0.012765957,7482934
"1:236594931:<DEL>:325:2137.705:Lumpy:SVtyper:0.428","<DEL>","1",236594931,325,NA,0,"Human",0.65106383,236595256
"20:2864012:<DEL>:322:696.29:Lumpy:SVtyper:0.460","<DEL>","20",2864012,322,NA,0,"Human",0.642553191,2864334
"7:2828757:<DEL>:285:520.20:Lumpy:SVtyper:0.007","<DEL>","7",2828757,285,NA,0,"Human",0.017021277,2829042
"13:23675485:<DEL>:323:980.27:Lumpy:SVtyper:0.004","<DEL>","13",23675485,323,"intergenic",0,"Human",0.008510638,23675808
"1:1531201:<DUP>:324:147.90:Lumpy:SVtyper:0.004","<DUP>","1",1531201,324,"intergenic",0,"Human",0.004255319,1531525
"4:28564287:<DEL>:324:677.14:Lumpy:SVtyper:0.159","<DEL>","4",28564287,324,"intergenic",0,"Human",0.268085106,28564611
"3:131354668:<DEL>:275:730.54:Lumpy:SVtyper:0.054","<DEL>","3",131354668,275,NA,0,"Human",0.110638298,131354943
"3:194614724:<DEL>:316:965.025:Lumpy:SVtyper:0.188","<DEL>","3",194614724,316,"intergenic",0,"Human",0.34893617,194615040
"5:12186489:<DEL>:304:351.10:Lumpy:SVtyper:0.127","<DEL>","5",12186489,304,"intergenic",0,"Human",0.221276596,12186793
"1:233730185:<DEL>:301:186.87:Lumpy:SVtyper:0.007","<DEL>","1",233730185,301,"intergenic",0,"Human",0.008510638,233730486
"4:101751938:<DEL>:325:625.64:Lumpy:SVtyper:0.047","<DEL>","4",101751938,325,"intergenic",0,"Human",0.085106383,101752263
"16:58290906:<DEL>:318:758.595:Lumpy:SVtyper:0.138","<DEL>","16",58290906,318,NA,0,"Human",0.246808511,58291224
"4:189137197:<DEL>:307:524.925:Lumpy:SVtyper:0.094","<DEL>","4",189137197,307,"intergenic",0,"Human",0.170212766,189137504
"1:83042645:<DEL>:320:2075.365:Lumpy:SVtyper:0.522","<DEL>","1",83042645,320,"intergenic",0,"Human",0.714893617,83042965
"14:79346295:<DEL>:312:642.63:Lumpy:SVtyper:0.004","<DEL>","14",79346295,312,NA,0,"Human",0.004255319,79346607
"3:2633037:<DEL>:321:826.00:Lumpy:SVtyper:0.004","<DEL>","3",2633037,321,NA,0,"Human",0.004255319,2633358
"14:64225565:<DEL>:308:406.93:Lumpy:SVtyper:0.004","<DEL>","14",64225565,308,"intergenic",0,"Human",0.012765957,64225873
"4:86462295:<DEL>:321:1076.27:Lumpy:SVtyper:0.018","<DEL>","4",86462295,321,NA,0,"Human",0.034042553,86462616
"1:91624784:<DEL>:284:2078.86:Lumpy:SVtyper:0.783","<DEL>","1",91624784,284,"intergenic",0,"Human",0.795744681,91625068
"15:55429901:<DEL>:321:568.48:Lumpy:SVtyper:0.475","<DEL>","15",55429901,321,"intergenic",0,"Human",0.804255319,55430222
"17:67087662:<DEL>:311:1064.67:Lumpy:SVtyper:0.014","<DEL>","17",67087662,311,NA,0,"Human",0.034042553,67087973
"10:53827671:<DEL>:318:720.30:Lumpy:SVtyper:0.178","<DEL>","10",53827671,318,NA,0,"Human",0.319148936,53827989
"10:14936354:<DEL>:317:952.22:Lumpy:SVtyper:0.264","<DEL>","10",14936354,317,NA,0,"Human",0.438297872,14936671
"22:45983106:<DEL>:283:489.45:Lumpy:SVtyper:0.004","<DEL>","22",45983106,283,NA,0,"Human",0.008510638,45983389
"10:129565306:<DEL>:306:1756.97:Lumpy:SVtyper:0.659","<DEL>","10",129565306,306,"intergenic",0,"Human",0.791489362,129565612
"7:84005632:<DEL>:320:758.715:Lumpy:SVtyper:0.123","<DEL>","7",84005632,320,"intergenic",0,"Human",0.234042553,84005952
"3:197316614:<DEL>:278:262.65:Lumpy:SVtyper:0.112","<DEL>","3",197316614,278,"intergenic",0,"Human",0.212765957,197316892
"8:104382905:<DEL>:320:440.37:Lumpy:SVtyper:0.145","<DEL>","8",104382905,320,NA,0,"Human",0.255319149,104383225
"10:115509125:<DEL>:314:645.455:Lumpy:SVtyper:0.098","<DEL>","10",115509125,314,"intergenic",0,"Human",0.174468085,115509439
"4:164501950:<DEL>:313:1130.15:Lumpy:SVtyper:0.388","<DEL>","4",164501950,313,NA,0,"Human",0.574468085,164502263
"9:138867300:<DEL>:283:244.04:Lumpy:SVtyper:0.007","<DEL>","9",138867300,283,"intergenic",0,"Human",0.012765957,138867583
"14:42650938:<DEL>:317:962.465:Lumpy:SVtyper:0.138","<DEL>","14",42650938,317,"intergenic",0,"Human",0.255319149,42651255
"1:240290383:<DEL>:318:374.3:Lumpy:SVtyper:0.004","<DEL>","1",240290383,318,NA,0,"Human",0.008510638,240290701
"12:98974066:<DEL>:303:195.77:Lumpy:SVtyper:0.217","<DEL>","12",98974066,303,"intergenic",0,"Human",0.34893617,98974369
"6:167907300:<DEL>:317:899.48:Lumpy:SVtyper:0.004","<DEL>","6",167907300,317,"intergenic",0,"Human",0.008510638,167907617
"9:97292915:<DEL>:325:1712.88:Lumpy:SVtyper:0.047","<DEL>","9",97292915,325,"intergenic",0,"Human",0.059574468,97293240
"7:63833136:<DEL>:305:742.12:Lumpy:SVtyper:0.120","<DEL>","7",63833136,305,"intergenic",0,"Human",0.246808511,63833441
"16:87597538:<DEL>:283:814.925:Lumpy:SVtyper:0.007","<DEL>","16",87597538,283,"intergenic",0,"Human",0.008510638,87597821
"4:141633312:<DEL>:296:809.30:Lumpy:SVtyper:0.022","<DEL>","4",141633312,296,NA,0,"Human",0.034042553,141633608
"16:62419377:<DEL>:317:981.07:Lumpy:SVtyper:0.018","<DEL>","16",62419377,317,"intergenic",0,"Human",0.042553191,62419694
"10:54441197:<DEL>:317:775.045:Lumpy:SVtyper:0.051","<DEL>","10",54441197,317,"intergenic",0,"Human",0.09787234,54441514
"6:129737083:<DEL>:314:958.42:Lumpy:SVtyper:0.355","<DEL>","6",129737083,314,NA,0,"Human",0.561702128,129737397
"2:56071108:<DEL>:290:889.11:Lumpy:SVtyper:0.091","<DEL>","2",56071108,290,"intergenic",0,"Human",0.170212766,56071398
"16:4067207:<DEL>:325:514.53:Lumpy:SVtyper:0.007","<DEL>","16",4067207,325,NA,0,"Human",0.012765957,4067532
"21:24742244:<DEL>:314:1115.78:Lumpy:SVtyper:0.319","<DEL>","21",24742244,314,"intergenic",0,"Human",0.519148936,24742558
"2:82757146:<DEL>:299:638.31:Lumpy:SVtyper:0.123","<DEL>","2",82757146,299,"intergenic",0,"Human",0.212765957,82757445
"6:25897990:<DEL>:316:849.345:Lumpy:SVtyper:0.014","<DEL>","6",25897990,316,"intergenic",0,"Human",0.034042553,25898306
"1:56401293:<DEL>:321:2202.37:Lumpy:SVtyper:0.797","<DEL>","1",56401293,321,"intergenic",0,"Human",0.829787234,56401614
"6:109096501:<DUP>:306:178.10:Lumpy:SVtyper:0.004","<DUP>","6",109096501,306,"intergenic",0,"Human",0.004255319,109096807
"7:96067515:<DEL>:315:479.46:Lumpy:SVtyper:0.007","<DEL>","7",96067515,315,"intergenic",0,"Human",0.012765957,96067830
"14:82181162:<DUP>:300:438.195:Lumpy:SVtyper:0.004","<DUP>","14",82181162,300,"intergenic",0,"Human",0.008510638,82181462
"2:208910342:<DEL>:315:300.955:Lumpy:SVtyper:0.286","<DEL>","2",208910342,315,"intergenic",0,"Human",0.468085106,208910657
"12:6538422:<DEL>:316:116.22:Lumpy:SVtyper:0.116","<DEL>","12",6538422,316,"intergenic",0,"Human",0.178723404,6538738
"6:878279:<DEL>:287:509.81:Lumpy:SVtyper:0.014","<DEL>","6",878279,287,"intergenic",0,"Human",0.034042553,878566
"11:71861600:<DEL>:315:1119.81:Lumpy:SVtyper:0.717","<DEL>","11",71861600,315,"intergenic",0,"Human",0.808510638,71861915
"5:62704439:<DEL>:323:1260.6:Lumpy:SVtyper:0.656","<DEL>","5",62704439,323,"intergenic",0,"Human",0.8,62704762
"5:23910428:<DEL>:286:810.775:Lumpy:SVtyper:0.087","<DEL>","5",23910428,286,"intergenic",0,"Human",0.174468085,23910714
"10:54441197:<DEL>:317:2091.04:Lumpy:SVtyper:0.228","<DEL>","10",54441197,317,"intergenic",0,"Human",0.246808511,54441514
"12:130383661:<DEL>:314:842.455:Lumpy:SVtyper:0.054","<DEL>","12",130383661,314,NA,0,"Human",0.10212766,130383975
"3:186826659:<DEL>:314:665.55:Lumpy:SVtyper:0.417","<DEL>","3",186826659,314,"intergenic",0,"Human",0.629787234,186826973
"13:59044764:<DEL>:316:630.76:Lumpy:SVtyper:0.043","<DEL>","13",59044764,316,"intergenic",0,"Human",0.093617021,59045080
"4:141145854:<DEL>:292:1053.07:Lumpy:SVtyper:0.170","<DEL>","4",141145854,292,"intergenic",0,"Human",0.306382979,141146146
"13:72956720:<DEL>:310:1305.53:Lumpy:SVtyper:0.696","<DEL>","13",72956720,310,"intergenic",0,"Human",0.825531915,72957030
"2:241379906:<DEL>:277:276.67:Lumpy:SVtyper:0.007","<DEL>","2",241379906,277,NA,0,"Human",0.012765957,241380183
"9:36309289:<DEL>:321:156.93:Lumpy:SVtyper:0.011","<DEL>","9",36309289,321,"intergenic",0,"Human",0.012765957,36309610
"3:169268603:<DEL>:279:351.91:Lumpy:SVtyper:0.228","<DEL>","3",169268603,279,NA,0,"Human",0.395744681,169268882
"10:78800903:<DEL>:319:2200.355:Lumpy:SVtyper:0.007","<DEL>","10",78800903,319,NA,0,"Human",0.012765957,78801222
"12:110307358:<DEL>:290:456.285:Lumpy:SVtyper:0.004","<DEL>","12",110307358,290,NA,0,"Human",0.008510638,110307648
"4:72785708:<DEL>:324:1333.27:Lumpy:SVtyper:0.065","<DEL>","4",72785708,324,"intergenic",0,"Human",0.119148936,72786032
"1:184278732:<DEL>:316:1064.32:Lumpy:SVtyper:0.014","<DEL>","1",184278732,316,"intergenic",0,"Human",0.025531915,184279048
"4:95498967:<DEL>:316:2230.41:Lumpy:SVtyper:0.790","<DEL>","4",95498967,316,NA,0,"Human",0.808510638,95499283
"5:99759471:<DEL>:318:1277.44:Lumpy:SVtyper:0.833","<DEL>","5",99759471,318,"intergenic",0,"Human",0.863829787,99759789
"2:65807511:<DEL>:310:1911.83:Lumpy:SVtyper:0.627","<DEL>","2",65807511,310,"intergenic",0,"Human",0.770212766,65807821
"5:121294708:<DEL>:307:123.76:Lumpy:SVtyper:0.011","<DEL>","5",121294708,307,"intergenic",0,"Human",0.017021277,121295015
"5:35614185:<DEL>:313:503.615:Lumpy:SVtyper:0.004","<DEL>","5",35614185,313,"intergenic",0,"Human",0.004255319,35614498
"3:170119571:<DEL>:313:1484.85:Lumpy:SVtyper:0.688","<DEL>","3",170119571,313,"intergenic",0,"Human",0.8,170119884
"10:119979197:<DEL>:315:584.79:Both:Both:0.062","<DEL>","10",119979197,315,"intergenic",0,"Human",0.114893617,119979512
"4:98590657:<DEL>:318:806.99:Lumpy:SVtyper:0.007","<DEL>","4",98590657,318,NA,0,"Human",0.012765957,98590975
"3:78779419:<DEL>:300:802.54:Lumpy:SVtyper:0.428","<DEL>","3",78779419,300,NA,0,"Human",0.689361702,78779719
"14:105738134:<DEL>:284:243.51:Lumpy:SVtyper:0.004","<DEL>","14",105738134,284,NA,0,"Human",0.008510638,105738418
"X:148686916:<DEL>:285:392.63:Lumpy:SVtyper:0.005","<DEL>","X",148686916,285,NA,0,"Human",0.008510638,148687201
"12:77908657:<DEL>:323:1102.97:Lumpy:SVtyper:0.004","<DEL>","12",77908657,323,"intergenic",0,"Human",0.012765957,77908980
"4:157002035:<DEL>:311:2351.71:Lumpy:SVtyper:0.801","<DEL>","4",157002035,311,"intergenic",0,"Human",0.838297872,157002346
"10:129946569:<DEL>:320:792.295:Lumpy:SVtyper:0.196","<DEL>","10",129946569,320,"intergenic",0,"Human",0.323404255,129946889
"chr7:152443599:<DEL>:322:23510.15","<DEL>","chr7",152443599,322,NA,0,"Macaque",0.65625,152443921
"chr4:149754476:<DEL>:311:33510.32","<DEL>","chr4",149754476,311,NA,0,"Macaque",0.84375,149754787
"chr16:74808170:<DEL>:313:14952.5","<DEL>","chr16",74808170,313,NA,0,"Macaque",0.78125,74808483
"chr11:65460150:<DEL>:321:13673.07","<DEL>","chr11",65460150,321,NA,0,"Macaque",0.84375,65460471
"chr4:107896282:<DEL>:321:9855.08","<DEL>","chr4",107896282,321,NA,0,"Macaque",0.5,107896603
"chr12:113817054:<DEL>:315:3050.97","<DEL>","chr12",113817054,315,NA,0,"Macaque",0.65625,113817369
"chr5:93726197:<DEL>:306:18459.09","<DEL>","chr5",93726197,306,NA,0,"Macaque",0.8125,93726503
"chr5:4185805:<DEL>:287:1830.55","<DEL>","chr5",4185805,287,NA,0,"Macaque",0.3125,4186092
"chr18:58361142:<DEL>:308:11059.21","<DEL>","chr18",58361142,308,NA,0,"Macaque",0.4375,58361450
"chr2:59535977:<DEL>:313:17273.28","<DEL>","chr2",59535977,313,NA,0,"Macaque",0.65625,59536290
"chr10:86745527:<DEL>:322:17078.89","<DEL>","chr10",86745527,322,NA,0,"Macaque",0.6875,86745849
"chr5:91161325:<DEL>:309:31694.49","<DEL>","chr5",91161325,309,NA,0,"Macaque",0.90625,91161634
"chr19:926733:<DEL>:323:3743.09","<DEL>","chr19",926733,323,NA,0,"Macaque",0.625,927056
"chr2:66717904:<DEL>:309:26969.63","<DEL>","chr2",66717904,309,NA,0,"Macaque",0.90625,66718213
"chr15:3144412:<DEL>:306:24354.39","<DEL>","chr15",3144412,306,NA,0,"Macaque",0.625,3144718
"chr7:24830814:<DEL>:310:18153.2","<DEL>","chr7",24830814,310,NA,0,"Macaque",0.6875,24831124
"chr12:37540249:<DEL>:301:15093.72","<DEL>","chr12",37540249,301,NA,0,"Macaque",0.71875,37540550
"chr8:58246436:<DEL>:325:7629.2","<DEL>","chr8",58246436,325,NA,0,"Macaque",0.375,58246761
"chr15:48505051:<DEL>:314:27940.42","<DEL>","chr15",48505051,314,NA,0,"Macaque",0.875,48505365
"chr3:185371606:<DEL>:306:6925.03","<DEL>","chr3",185371606,306,"ENSMMUG00000006973.3",1,"Macaque",0.75,185371912
"chr4:166527369:<DEL>:319:9543.47","<DEL>","chr4",166527369,319,NA,0,"Macaque",0.4375,166527688
"chr1:98281997:<DUP>:277:2647.92","<DUP>","chr1",98281997,277,NA,0,"Macaque",0.28125,98282274
"chr6:178453518:<DEL>:319:21942.83","<DEL>","chr6",178453518,319,NA,0,"Macaque",0.84375,178453837
"chr9:129265921:<DEL>:282:22899.68","<DEL>","chr9",129265921,282,NA,0,"Macaque",0.6875,129266203
"chr7:16410557:<DEL>:323:32728.22","<DEL>","chr7",16410557,323,NA,0,"Macaque",0.875,16410880
"chr8:34439335:<DEL>:311:9385.91","<DEL>","chr8",34439335,311,NA,0,"Macaque",0.34375,34439646
"chr3:2988630:<DEL>:284:13123.01","<DEL>","chr3",2988630,284,NA,0,"Macaque",0.9375,2988914
"chr10:1913343:<DEL>:282:7131.2","<DEL>","chr10",1913343,282,NA,0,"Macaque",0.75,1913625
"chr19:14928486:<DEL>:313:4163.91","<DEL>","chr19",14928486,313,NA,0,"Macaque",0.8125,14928799
"chr12:110502933:<DEL>:309:8123.31","<DEL>","chr12",110502933,309,NA,0,"Macaque",0.4375,110503242
"chr2:132736519:<DEL>:313:10852.95","<DEL>","chr2",132736519,313,NA,0,"Macaque",0.46875,132736832
"chr13:36066248:<DEL>:312:32540.27","<DEL>","chr13",36066248,312,NA,0,"Macaque",0.875,36066560
"chr10:38089124:<DEL>:316:10158.03","<DEL>","chr10",38089124,316,NA,0,"Macaque",0.40625,38089440
"chr2:158278346:<DEL>:288:13152.83","<DEL>","chr2",158278346,288,NA,0,"Macaque",0.9375,158278634
"chr3:161174575:<DEL>:309:27695.5","<DEL>","chr3",161174575,309,NA,0,"Macaque",0.9375,161174884
"chr6:112035832:<DEL>:309:34688.28","<DEL>","chr6",112035832,309,NA,0,"Macaque",0.84375,112036141
"chr13:98805509:<DUP>:298:1937.08","<DUP>","chr13",98805509,298,NA,0,"Macaque",0.28125,98805807
"chr13:38894592:<DEL>:322:21770.6","<DEL>","chr13",38894592,322,NA,0,"Macaque",0.65625,38894914
"chr4:170492507:<DEL>:302:19954.0","<DEL>","chr4",170492507,302,NA,0,"Macaque",0.90625,170492809
"chr9:61416457:<DUP>:306:584.87","<DUP>","chr9",61416457,306,NA,0,"Macaque",0.09375,61416763
"chr4:112561376:<DEL>:321:20010.17","<DEL>","chr4",112561376,321,NA,0,"Macaque",0.65625,112561697
"chr9:3004510:<DEL>:320:32499.66","<DEL>","chr9",3004510,320,NA,0,"Macaque",0.9375,3004830
"chr16:70021541:<DEL>:321:14551.3","<DEL>","chr16",70021541,321,NA,0,"Macaque",0.59375,70021862
"chr6:56553817:<DEL>:289:16565.44","<DEL>","chr6",56553817,289,NA,0,"Macaque",0.8125,56554106
"chr3:183977594:<DEL>:296:9293.13","<DEL>","chr3",183977594,296,NA,0,"Macaque",0.8125,183977890
"chr6:177913381:<DEL>:324:5277.51","<DEL>","chr6",177913381,324,NA,0,"Macaque",0.5,177913705
"chr3:183986582:<DEL>:279:1920.22","<DEL>","chr3",183986582,279,NA,0,"Macaque",0.625,183986861
"chr4:169937608:<DEL>:321:6070.69","<DEL>","chr4",169937608,321,NA,0,"Macaque",0.625,169937929
"chr1:87160947:<DEL>:323:10504.75","<DEL>","chr1",87160947,323,NA,0,"Macaque",0.625,87161270
"chr11:2797747:<DEL>:321:21309.98","<DEL>","chr11",2797747,321,NA,0,"Macaque",0.90625,2798068
"chr10:46145596:<DEL>:320:15794.46","<DEL>","chr10",46145596,320,NA,0,"Macaque",0.65625,46145916
"chr2:204380148:<DUP>:301:3602.1","<DUP>","chr2",204380148,301,NA,0,"Macaque",0.9375,204380449
"chr16:76927767:<DEL>:320:14507.44","<DEL>","chr16",76927767,320,NA,0,"Macaque",0.5625,76928087
"chr19:5288591:<DEL>:317:15677.27","<DEL>","chr19",5288591,317,NA,0,"Macaque",0.75,5288908
"chr3:184452927:<DEL>:304:5510.37","<DEL>","chr3",184452927,304,NA,0,"Macaque",0.71875,184453231
"chr9:35784558:<DEL>:316:36610.65","<DEL>","chr9",35784558,316,NA,0,"Macaque",0.9375,35784874
"chr2:93926090:<DUP>:295:2394.66","<DUP>","chr2",93926090,295,NA,0,"Macaque",0.3125,93926385
"chr15:104331395:<DEL>:315:20282.65","<DEL>","chr15",104331395,315,NA,0,"Macaque",0.90625,104331710
"chr10:4708945:<DEL>:290:18284.96","<DEL>","chr10",4708945,290,NA,0,"Macaque",0.9375,4709235
"chr17:70338304:<DEL>:318:27025.45","<DEL>","chr17",70338304,318,NA,0,"Macaque",0.84375,70338622
"chr13:107223524:<DEL>:318:9436.15","<DEL>","chr13",107223524,318,NA,0,"Macaque",0.4375,107223842
"chr6:579702:<DUP>:287:3082.13","<DUP>","chr6",579702,287,NA,0,"Macaque",0.625,579989
"chr4:3258977:<DEL>:323:4866.93","<DEL>","chr4",3258977,323,NA,0,"Macaque",0.28125,3259300
"chr10:57374609:<DEL>:320:32585.92","<DEL>","chr10",57374609,320,NA,0,"Macaque",0.875,57374929
"chr3:31447889:<DEL>:320:12687.82","<DEL>","chr3",31447889,320,NA,0,"Macaque",0.875,31448209
"chr13:80318224:<DEL>:320:11080.29","<DEL>","chr13",80318224,320,NA,0,"Macaque",0.46875,80318544
"chr11:37307125:<DEL>:325:14998.44","<DEL>","chr11",37307125,325,NA,0,"Macaque",0.84375,37307450
"chr13:104174959:<DUP>:297:526.03","<DUP>","chr13",104174959,297,NA,0,"Macaque",0.09375,104175256
"chr2:18707723:<DEL>:295:13032.52","<DEL>","chr2",18707723,295,NA,0,"Macaque",0.8125,18708018
"chr14:1138402:<DEL>:319:8376.18","<DEL>","chr14",1138402,319,NA,0,"Macaque",0.84375,1138721
"chr7:150757626:<DEL>:296:14249.91","<DEL>","chr7",150757626,296,NA,0,"Macaque",0.53125,150757922
"chr4:35484825:<DEL>:322:18361.15","<DEL>","chr4",35484825,322,NA,0,"Macaque",0.8125,35485147
"chr16:68092217:<DEL>:318:12494.03","<DEL>","chr16",68092217,318,NA,0,"Macaque",0.8125,68092535
"chr6:2076613:<DEL>:306:6465.79","<DEL>","chr6",2076613,306,NA,0,"Macaque",0.8125,2076919
"chr20:8867393:<DEL>:301:13334.14","<DEL>","chr20",8867393,301,NA,0,"Macaque",0.90625,8867694
"chr9:123474442:<DEL>:319:7644.13","<DEL>","chr9",123474442,319,NA,0,"Macaque",0.65625,123474761
"chr1:38783508:<DEL>:298:18014.86","<DEL>","chr1",38783508,298,NA,0,"Macaque",0.9375,38783806
"chr4:79233312:<DUP>:319:1348.19","<DUP>","chr4",79233312,319,NA,0,"Macaque",0.40625,79233631
"chr7:144539688:<DEL>:320:24555.58","<DEL>","chr7",144539688,320,NA,0,"Macaque",0.9375,144540008
"chr14:83864183:<DEL>:307:12852.67","<DEL>","chr14",83864183,307,NA,0,"Macaque",0.5,83864490
"chr15:109867307:<DEL>:303:10636.58","<DEL>","chr15",109867307,303,NA,0,"Macaque",0.78125,109867610
"chr17:44598671:<DEL>:312:13147.19","<DEL>","chr17",44598671,312,NA,0,"Macaque",0.5,44598983
"chr10:92166371:<DEL>:319:39413.01","<DEL>","chr10",92166371,319,NA,0,"Macaque",0.9375,92166690
"chr9:118215327:<DEL>:320:22355.22","<DEL>","chr9",118215327,320,NA,0,"Macaque",0.8125,118215647
"chr20:1230748:<DEL>:284:16129.26","<DEL>","chr20",1230748,284,NA,0,"Macaque",0.875,1231032
"chr17:86470706:<DEL>:306:7212.77","<DEL>","chr17",86470706,306,NA,0,"Macaque",0.3125,86471012
"chr19:1184399:<DEL>:309:23389.73","<DEL>","chr19",1184399,309,NA,0,"Macaque",0.8125,1184708
"chr12:5178063:<DEL>:307:8440.22","<DEL>","chr12",5178063,307,NA,0,"Macaque",0.5,5178370
"chr6:157382927:<DEL>:308:28765.37","<DEL>","chr6",157382927,308,NA,0,"Macaque",0.875,157383235
"chr3:16357561:<DEL>:305:20934.84","<DEL>","chr3",16357561,305,NA,0,"Macaque",0.59375,16357866
"chr9:20346749:<DEL>:325:17554.39","<DEL>","chr9",20346749,325,NA,0,"Macaque",0.90625,20347074
"chr16:48713338:<DEL>:312:36400.03","<DEL>","chr16",48713338,312,NA,0,"Macaque",0.9375,48713650
"chr16:76799749:<DEL>:286:2126.88","<DEL>","chr16",76799749,286,NA,0,"Macaque",0.3125,76800035
"chr20:2141965:<DEL>:311:32228.04","<DEL>","chr20",2141965,311,NA,0,"Macaque",0.90625,2142276
"chr17:83529691:<DEL>:312:19488.6","<DEL>","chr17",83529691,312,NA,0,"Macaque",0.6875,83530003
"chr13:95678457:<DEL>:284:8992.06","<DEL>","chr13",95678457,284,NA,0,"Macaque",0.5625,95678741
"chr9:2092955:<DEL>:313:23591.03","<DEL>","chr9",2092955,313,NA,0,"Macaque",0.90625,2093268
"chr2:161303013:<DEL>:324:22738.21","<DEL>","chr2",161303013,324,NA,0,"Macaque",0.84375,161303337
"chr7:85593930:<DEL>:318:4701.14","<DEL>","chr7",85593930,318,NA,0,"Macaque",0.28125,85594248
"chr18:50062644:<DEL>:309:18601.6","<DEL>","chr18",50062644,309,NA,0,"Macaque",0.8125,50062953
"chr2:99294241:<DEL>:318:19430.49","<DEL>","chr2",99294241,318,NA,0,"Macaque",0.6875,99294559
"chr18:69452721:<DEL>:277:15854.72","<DEL>","chr18",69452721,277,NA,0,"Macaque",0.78125,69452998
"chr19:48756163:<DEL>:311:5452.87","<DEL>","chr19",48756163,311,"ENSMMUG00000006778.3",1,"Macaque",0.3125,48756474
"chr4:430039:<DEL>:313:35260.88","<DEL>","chr4",430039,313,NA,0,"Macaque",0.84375,430352
"chr17:86873216:<DEL>:319:28852.48","<DEL>","chr17",86873216,319,NA,0,"Macaque",0.9375,86873535
"chr18:69358608:<DEL>:305:2424.21","<DEL>","chr18",69358608,305,NA,0,"Macaque",0.34375,69358913
"chr19:52633016:<DEL>:325:25371.69","<DEL>","chr19",52633016,325,NA,0,"Macaque",0.9375,52633341
"chr4:4449458:<DUP>:325:149.84","<DUP>","chr4",4449458,325,NA,0,"Macaque",0.03125,4449783
